30 100
GTTTCAGTCGTCGCTTTAGGATCTATCGCC|GGCTCGTATTACGGGGGAATTTACTGGGAG
TTAGGGGTCACTAGGAGGCTTACGTGGAGC|TCAGGCTGACTTACGCCGAGTTTACTAGGG
TTATTTAGGGACTTAGTTACTAAACGGAGG|TGATAGTAGTGAATTTGTGAAGCGAGCGAT
AGCGAGCGATCCTACCGGTCGTATAGCGAC|TTCAGTGGGGTGCAGACAGAGTTAGAACCG
CACTTGGCTTCCTGGATGTCAAAGAGGCAC|CGTTTTACTATCGTATCGGTCCCCCGCCGA
GGCTACTACGTTATTCCGTCTACTCGATAC|AGTGGTTTCAGTGACACTGGCCATCTTAAG
TAGTGGTTTCAGCACACGGAGGCTTACGTG|GTGGTTTCAGACGTCCCGTACTTGCCCGGA
CGTTATTCCGTCTACTCGATACCTGATGAT|CAGTGACACTGGCCATCTTAAGGAGGCTTA
GAGGCTTACGTGGAGCTTAGTGGTTTCAGG|TAGTCAAAACCCTACCGGAGGCTTACGTGG
ACATTTCAACCTAGCCCGTCGTGGAGGCTT|CTTACGTGGAGGCTTACGTGGAGCTTAGTG
ATTACGGGGGAATTTACTGGGAGGCTTACG|AAGGATAGCCAAGTGAGGAGCTAATCGGGA
TTCAGCCATATCTTTTCAACGGACTAGCCA|CCGTTATGGTCAAACACTTGGCTTCCTGGA
GGAGGCTTACGTGGAGCTTAGTGGTTTCAG|AACGGACTAGCCAGACGCGGCGCGGCTCGT
GTCCCGTACTTGCCCGGAGGCTTACGTGGA|TCGTCCGTGCTCTTCTTAATGGTTGGCTTG
TCGCGAGCGCCCTCCTCGCTAAAAGGATGA|TTACGTGGAGCTTAGTGGTTTCAGCCATAT
GACAGAGTTAGAACCGAAAAGTTCGATACC|CATCCACTCTTTACTTGTATTAATAGTGTA
TATTCCGTCTACTCGATACCTGATGATAGT|TGACACTGGCCATCTTAAGGAGGCTTACGT
ATTATTTAGGGACTTAGTTACTAAACGGAG|ATGATAGTAGTGAATTTGTGAAGCGAGCGA
CTCGACGCGCTCTATACAGCCGCCTCGTCC|CTTCGGAGGCTTACGTGGAGCTTAGTGGTT
TGGAGCTTAGTGGTTTCAGTCGTCGCTTTA|CAGACGCGGCGCGGCTCGTATTACGGGGGA
CAGACGACATCCACACATTTCAACCTAGCC|GAGATACTTGGAGGCTTACGTGGAGGCTTA
ACGACATCCACACATTTCAACCTAGCCCGT|ATACTTGGAGGCTTACGTGGAGGCTTACGT
GGAGCTTAGTGGTTTCAGAGGAGATACTTG|TTACGTGGAGCTTAGTGGTTTCAGAATAAA
GTGGAGCTTAGTGGTTTCAGAATAAACAAT|GGAGGCTTACGTGGAGCTTAGTGGTTTCAG
GTGAAGCGAGCGATCCTACCGGTCGTATAG|TGGTTTCAGTGGGGTGCAGACAGAGTTAGA
CTATCGTATCGGTCCCCCGCCGAACGTCAG|CGATGCGCGTTATGGGGAGGCTTACGTGGA
GTCGCCTCCGGTGACCCCCCTATCACTCTA|TCGTTTCGCGAGCGCCCTCCTCGCTAAAAG
GGCTTACGTGGAGCTTAGTGGTTTCAGAAT|CTTGCCCGGAGGCTTACGTGGAGCTTAGTG
CCCCTATCACTCTACCCGCGCCTCGACGCG|CTCCTCGCTAAAAGGATGACGCTTCGGAGG
TACCTCATCGAGATCGACGCGAAGTGGTAG|ATCACAAGGGTTACGTCGCCTCCGGTGACC
ACGCGCTCTATACAGCCGCCTCGTCCGTGC|GGAGGCTTACGTGGAGCTTAGTGGTTTCAG
GTATTACGGGGGAATTTACTGGGAGGCTTA|TAAAGGATAGCCAAGTGAGGAGCTAATCGG
TAGTGGTTTCAGTGACACTGGCCATCTTAA|CCACCGGTACCCTAGTGAACCCCGTGAAGT
GTTTCAGACGTCCCGTACTTGCCCGGAGGC|ACAGCCGCCTCGTCCGTGCTCTTCTTAATG
AGTGAGGAGCTAATCGGGATTTTGTCCGGG|TACTACGTTATTCCGTCTACTCGATACCTG
CGGCGCGGCTCGTATTACGGGGGAATTTAC|AAAGAGGCACTTAAAGGATAGCCAAGTGAG
CCCTCCTCGCTAAAAGGATGACGCTTCGGA|GCTTAGTGGTTTCAGCCATATCTTTTCAAC
CTAGCCAGACGCGGCGCGGCTCGTATTACG|TCCTGGATGTCAAAGAGGCACTTAAAGGAT
GGAGCTTAGTGGTTTCAGAATAAACAATCC|AGGCTTACGTGGAGCTTAGTGGTTTCAGAT
CGAGCGATCCTACCGGTCGTATAGCGACCG|CAGTGGGGTGCAGACAGAGTTAGAACCGAA
TTTCAGACGTCCCGTACTTGCCCGGAGGCT|CAGCCGCCTCGTCCGTGCTCTTCTTAATGG
GTTTCAGTTGGAGGCTTACGGAGGCTTACG|CGTGGAGCTTAGTGGTTTCAGGGGAGCTTA
TGGTTTCAGGTGGAGCTTAGTGGTTTCAGA|CACACGGAGGCTTACGTGGAGCTTAGTGGT
TCAGTCGTCGCTTTAGGATCTATCGCCCGC|TCGTATTACGGGGGAATTTACTGGGAGGCT
TGGTTTCAGTCGTCGCTTTAGGATCTATCG|GCGGCTCGTATTACGGGGGAATTTACTGGG
GGCTTACGTGGAGGCTTACGTGGAGCTTAG|ATCCATTTAGAATACCTCATCGAGATCGAC
AGACGACATCCACACATTTCAACCTAGCCC|AGATACTTGGAGGCTTACGTGGAGGCTTAC
GCTTAGTGGTTTCAGAGGAGATACTTGGAG|CGTGGAGCTTAGTGGTTTCAGAATAAACAA
GAGCTTAGTGGTTTCAGCGTTTTACTATCG|TCGTATAGCGACCGCCCCATCTCGCGATGC
TTAGTGGTTTCAGAGGAGATACTTGGAGGC|TGGAGCTTAGTGGTTTCAGAATAAACAATC
GTGGTTTCAGGCTGACTTACGCCGAGTTTA|GGATTATTTAGGGACTTAGTTACTAAACGG
CGTGGAGGCTTACGTGGAGCTTAGTGGTTT|TTAGAATACCTCATCGAGATCGACGCGAAG
AGGGACTTAGTTACTAAACGGAGGCTTACG|TAGTGAATTTGTGAAGCGAGCGATCCTACC
TCAAAGAGGCACTTAAAGGATAGCCAAGTG|GTCCCCCGCCGAACGTCAGATTAGGCTACT
GGGGGAATTTACTGGGAGGCTTACGTGGAG|TAGCCAAGTGAGGAGCTAATCGGGATTTTG
TCCTACCGGTCGTATAGCGACCGCCCCATC|GTGCAGACAGAGTTAGAACCGAAAAGTTCG
TTACGTGGAGCTTAGTGGTTTCAGGAGGCT|CTCATCGAGATCGACGCGAAGTGGTAGTCA
TTAGTGGTTTCAGTTGGAGGCTTACGGAGG|GGCTTACGTGGAGCTTAGTGGTTTCAGGGG
GCTTAGTGGTTTCAGACGTCCCGTACTTGC|CGCTCTATACAGCCGCCTCGTCCGTGCTCT
CTCGTATTACGGGGGAATTTACTGGGAGGC|ACTTAAAGGATAGCCAAGTGAGGAGCTAAT
ATGGGAACGCAGCGTATCACTTATCGAGCG|CATGGAAGCCTCGGGACAGCTTAGGGGTCA
ACAGTCCCGTTATGGTCAAACACTTGGCTT|GTGGAGCTTAGTGGTTTCAGCGTTTTACTA
CCCCGCCGAACGTCAGATTAGGCTACTACG|GGGAGGCTTACGTGGAGCTTAGTGGTTTCA
TTGCTCACTCTTACACGTGCTGGGCGTTTC|GAGCTTAGTGGTTTCAGGTGGAGCTTAGTG
TTGTCCGGGATTATTTAGGGACTTAGTTAC|CGATACCTGATGATAGTAGTGAATTTGTGA
ACACTTGGCTTCCTGGATGTCAAAGAGGCA|GCGTTTTACTATCGTATCGGTCCCCCGCCG
CTCCGGTGACCCCCCTATCACTCTACCCGC|TCGCGAGCGCCCTCCTCGCTAAAAGGATGA
TACGTGGAGCTTAGTGGTTTCAGAATAAAC|CCCGGAGGCTTACGTGGAGCTTAGTGGTTT
GCTTAGTGGTTTCAGAATAAACAATCCATT|CTTACGTGGAGCTTAGTGGTTTCAGATCCT
TGTCCGGGATTATTTAGGGACTTAGTTACT|GATACCTGATGATAGTAGTGAATTTGTGAA
TACGGAGGCTTACGTGGAGCTTAGTGGTTT|TTCAGGGGAGCTTAGTGGTTTCAGCACACG
TTAGTGGTTTCAGCGTTTTACTATCGTATC|ATAGCGACCGCCCCATCTCGCGATGCGCGT
TTACTAGGGCCACAGTCCCGTTATGGTCAA|CGGAGGCTTACGTGGAGCTTAGTGGTTTCA
GAGGCTTACGTGGAGCTTAGTGGTTTCAGT|ACGGACTAGCCAGACGCGGCGCGGCTCGTA
GGCTTACGTGGAGCTTAGTGGTTTCAGTGG|TTCGACCCCATCCAAATCCAAACACCATAT
TTACGTGGAGCTTAGTGGTTTCAGTCGTCG|CTAGCCAGACGCGGCGCGGCTCGTATTACG
CTATCACTCTACCCGCGCCTCGACGCGCTC|CTCGCTAAAAGGATGACGCTTCGGAGGCTT
TCTCGCGATGCGCGTTATGGGGAGGCTTAC|CGATACCCAAGCGATCCTATGTAATAACTT
TAGTGGTTTCAGTCGTCGCTTTAGGATCTA|GGCGCGGCTCGTATTACGGGGGAATTTACT
GGTTATCACAAGGGTTACGTCGCCTCCGGT|TCACTTATCGAGCGATGATCGTTTCGCGAG
CGACGCGAAGTGGTAGTCAAAACCCTACCG|GTCGCCTCCGGTGACCCCCCTATCACTCTA
AGCTTAGTGGTTTCAGGGGAGCTTAGTGGT|ACCGGAGGCTTACGTGGAGCTTAGTGGTTT
TACGTGGAGCTTAGTGGTTTCAGGCTGACT|GGGATTTTGTCCGGGATTATTTAGGGACTT
GGAGCTTAGTGGTTTCAGCGTTTTACTATC|GTCGTATAGCGACCGCCCCATCTCGCGATG
GTGGAGCTTAGTGGTTTCAGTTGGAGGCTT|TTCAGGAGGCTTACGTGGAGCTTAGTGGTT
CCGTCGTGGAGGCTTACGTGGAGCTTAGTG|ACGTGGAGCTTAGTGGTTTCAGGAGGCTTA
TACGTGGAGCTTAGTGGTTTCAGTGACACT|CTTCGGAAAGGCCACCGGTACCCTAGTGAA
TTATGGTCAAACACTTGGCTTCCTGGATGT|AGTGGTTTCAGCGTTTTACTATCGTATCGG
GACCCCCCTATCACTCTACCCGCGCCTCGA|CGCCCTCCTCGCTAAAAGGATGACGCTTCG
ACGCTTCGGAGGCTTACGTGGAGCTTAGTG|TCTTTTCAACGGACTAGCCAGACGCGGCGC
TTATCACAAGGGTTACGTCGCCTCCGGTGA|ACTTATCGAGCGATGATCGTTTCGCGAGCG
AGAGTTAGAACCGAAAAGTTCGATACCCAA|CCACTCTTTACTTGTATTAATAGTGTACGT
TAGTGGTTTCAGCCATATCTTTTCAACGGA|CACAGTCCCGTTATGGTCAAACACTTGGCT
TCAGGAGGCTTACGTGGAGCTTAGTGGTTT|GTGGTAGTCAAAACCCTACCGGAGGCTTAC
CCTCCGGTGACCCCCCTATCACTCTACCCG|TTCGCGAGCGCCCTCCTCGCTAAAAGGATG
TATTTAGGGACTTAGTTACTAAACGGAGGC|GATAGTAGTGAATTTGTGAAGCGAGCGATC
TCAGGTGGAGCTTAGTGGTTTCAGAGGAGA|GGAGGCTTACGTGGAGCTTAGTGGTTTCAG
AAAGTTCGATACCCAAGCGATCCTATGTAA|TATTAATAGTGTACGTACTCCCAGTAAGAC
ACTCGATACCTGATGATAGTAGTGAATTTG|CATCTTAAGGAGGCTTACGTGGAGCTTAGT
GCCATCTTAAGGAGGCTTACGTGGAGCTTA|CCCGTGAAGTTAATTCGACCCCATCCAAAT
GCGGCTCGTATTACGGGGGAATTTACTGGG|AGGCACTTAAAGGATAGCCAAGTGAGGAGC
GTGGTTTCAGTGACACTGGCCATCTTAAGG|ACCGGTACCCTAGTGAACCCCGTGAAGTTA
GCGTTTTGCTCACTCTTACACGTGCTGGGC|ACGTGGAGCTTAGTGGTTTCAGGTGGAGCT
CGTTTTGCTCACTCTTACACGTGCTGGGCG|CGTGGAGCTTAGTGGTTTCAGGTGGAGCTT
TCTTTTCAACGGACTAGCCAGACGCGGCGC|CAAACACTTGGCTTCCTGGATGTCAAAGAG
GGCTTACGTGGAGCTTAGTGGTTTCAGTTG|TAGTGGTTTCAGGAGGCTTACGTGGAGCTT
AAAAGGATGACGCTTCGGAGGCTTACGTGG|TCAGCCATATCTTTTCAACGGACTAGCCAG
CGTCGCCTCCGGTGACCCCCCTATCACTCT|ATCGTTTCGCGAGCGCCCTCCTCGCTAAAA
GTGAGGAGCTAATCGGGATTTTGTCCGGGA|ACTACGTTATTCCGTCTACTCGATACCTGA
CATCTTAAGGAGGCTTACGTGGAGCTTAGT|CGTGAAGTTAATTCGACCCCATCCAAATCC
GAGCTTAGTGGTTTCAGGCTGACTTACGCC|TTGTCCGGGATTATTTAGGGACTTAGTTAC
GAAGCCTCGGGACAGCTTAGGGGTCACTAG|GTGGAGCTTAGTGGTTTCAGGCTGACTTAC
GCCTCGGGACAGCTTAGGGGTCACTAGGAG|GAGCTTAGTGGTTTCAGGCTGACTTACGCC
TCGAGATCGACGCGAAGTGGTAGTCAAAAC|GGGTTACGTCGCCTCCGGTGACCCCCCTAT
CATTTAGAATACCTCATCGAGATCGACGCG|TCCTAGGTTATCACAAGGGTTACGTCGCCT
GGAGCTTAGTGGTTTCAGTTGGAGGCTTAC|CAGGAGGCTTACGTGGAGCTTAGTGGTTTC
GCTTAGTGGTTTCAGTGACACTGGCCATCT|AGGCCACCGGTACCCTAGTGAACCCCGTGA
ACGTGGAGCTTAGTGGTTTCAGGCTGACTT|GGATTTTGTCCGGGATTATTTAGGGACTTA
ACAGCTTAGGGGTCACTAGGAGGCTTACGT|TGGTTTCAGGCTGACTTACGCCGAGTTTAC
GGAGGCTTACGTGGAGCTTAGTGGTTTCAG|ACCCGCGCCTCGACGCGCTCTATACAGCCG
ACGTGGAGCTTAGTGGTTTCAGGAGGCTTA|CATCGAGATCGACGCGAAGTGGTAGTCAAA
ATGTCAAAGAGGCACTTAAAGGATAGCCAA|TCGGTCCCCCGCCGAACGTCAGATTAGGCT
TTCAGGGGAGCTTAGTGGTTTCAGCACACG|ACGTGGAGCTTAGTGGTTTCAGACGTCCCG
CTAAACGGAGGCTTACGTGGAGCTTAGTGG|AAGCGAGCGATCCTACCGGTCGTATAGCGA
ACCCGCGCCTCGACGCGCTCTATACAGCCG|GGATGACGCTTCGGAGGCTTACGTGGAGCT
GGAGGCTTACGGAGGCTTACGTGGAGCTTA|TAGTGGTTTCAGGGGAGCTTAGTGGTTTCA
CTTAGGGGTCACTAGGAGGCTTACGTGGAG|TTCAGGCTGACTTACGCCGAGTTTACTAGG
TACGTCGCCTCCGGTGACCCCCCTATCACT|TGATCGTTTCGCGAGCGCCCTCCTCGCTAA
TAGTGGTTTCAGTTGGAGGCTTACGGAGGC|GCTTACGTGGAGCTTAGTGGTTTCAGGGGA
GATCGACGCGAAGTGGTAGTCAAAACCCTA|TACGTCGCCTCCGGTGACCCCCCTATCACT
TTTTGCTCACTCTTACACGTGCTGGGCGTT|TGGAGCTTAGTGGTTTCAGGTGGAGCTTAG
TGGTTTCAGACGTCCCGTACTTGCCCGGAG|ATACAGCCGCCTCGTCCGTGCTCTTCTTAA
GCCGAACGTCAGATTAGGCTACTACGTTAT|GGCTTACGTGGAGCTTAGTGGTTTCAGTGA
GTTTCAGCACACGGAGGCTTACGTGGAGCT|TTCAGACGTCCCGTACTTGCCCGGAGGCTT
TATGGTCAAACACTTGGCTTCCTGGATGTC|GTGGTTTCAGCGTTTTACTATCGTATCGGT
TCATCGAGATCGACGCGAAGTGGTAGTCAA|CAAGGGTTACGTCGCCTCCGGTGACCCCCC
TTACGTGGAGCTTAGTGGTTTCAGAATAAA|GCCCGGAGGCTTACGTGGAGCTTAGTGGTT
GGGGTGCAGACAGAGTTAGAACCGAAAAGT|ATGCACGCCATCCACTCTTTACTTGTATTA
GTCGTGGAGGCTTACGTGGAGCTTAGTGGT|GTGGAGCTTAGTGGTTTCAGGAGGCTTACG
TGACTTACGCCGAGTTTACTAGGGCCACAG|GACTTAGTTACTAAACGGAGGCTTACGTGG
CTATACAGCCGCCTCGTCCGTGCTCTTCTT|TACGTGGAGCTTAGTGGTTTCAGTCGTCGC
TGGAGGCTTACGTGGAGCTTAGTGGTTTCA|AGCTTAGTGGTTTCAGGAGGCTTACGTGGA
CTTACGTGGAGCTTAGTGGTTTCAGTGACA|AACTTCGGAAAGGCCACCGGTACCCTAGTG
TATCGGTCCCCCGCCGAACGTCAGATTAGG|GCGTTATGGGGAGGCTTACGTGGAGCTTAG
CGCCTCCGGTGACCCCCCTATCACTCTACC|GTTTCGCGAGCGCCCTCCTCGCTAAAAGGA
TGGTTTCAGGCTGACTTACGCCGAGTTTAC|GATTATTTAGGGACTTAGTTACTAAACGGA
TAGGATCTATCGCCCGCATGGAAGCCTCGG|GAATTTACTGGGAGGCTTACGTGGAGCTTA
GTTATGGGGAGGCTTACGTGGAGCTTAGTG|ATCCTATGTAATAACTTCGGAAAGGCCACC
CTTGCCCGGAGGCTTACGTGGAGCTTAGTG|GCTCTTCTTAATGGTTGGCTTGACCTCATG
TGGTTTCAGGGGAGCTTAGTGGTTTCAGCA|GCTTACGTGGAGCTTAGTGGTTTCAGACGT
AGAACCGAAAAGTTCGATACCCAAGCGATC|TTTACTTGTATTAATAGTGTACGTACTCCC
CTGGATGTCAAAGAGGCACTTAAAGGATAG|CGTATCGGTCCCCCGCCGAACGTCAGATTA
GGTTTCAGTCGTCGCTTTAGGATCTATCGC|CGGCTCGTATTACGGGGGAATTTACTGGGA
AAGGATAGCCAAGTGAGGAGCTAATCGGGA|TCAGATTAGGCTACTACGTTATTCCGTCTA
ACGCGGCGCGGCTCGTATTACGGGGGAATT|GTCAAAGAGGCACTTAAAGGATAGCCAAGT
CGCCGAGTTTACTAGGGCCACAGTCCCGTT|TTACTAAACGGAGGCTTACGTGGAGCTTAG
CGTTTTACTATCGTATCGGTCCCCCGCCGA|CATCTCGCGATGCGCGTTATGGGGAGGCTT
GTCGTCGCTTTAGGATCTATCGCCCGCATG|TATTACGGGGGAATTTACTGGGAGGCTTAC
AGTTTACTAGGGCCACAGTCCCGTTATGGT|AAACGGAGGCTTACGTGGAGCTTAGTGGTT
CCGGTCGTATAGCGACCGCCCCATCTCGCG|GACAGAGTTAGAACCGAAAAGTTCGATACC
ATGATAGTAGTGAATTTGTGAAGCGAGCGA|GCTTACGTGGAGCTTAGTGGTTTCAGTGGG
TTCAGTGACACTGGCCATCTTAAGGAGGCT|TACCCTAGTGAACCCCGTGAAGTTAATTCG
ACGTCCCGTACTTGCCCGGAGGCTTACGTG|CCTCGTCCGTGCTCTTCTTAATGGTTGGCT
CTTCCTGGATGTCAAAGAGGCACTTAAAGG|CTATCGTATCGGTCCCCCGCCGAACGTCAG
GACAGCTTAGGGGTCACTAGGAGGCTTACG|GTGGTTTCAGGCTGACTTACGCCGAGTTTA
CAGACGTCCCGTACTTGCCCGGAGGCTTAC|CCGCCTCGTCCGTGCTCTTCTTAATGGTTG
GTCAAAGAGGCACTTAAAGGATAGCCAAGT|GGTCCCCCGCCGAACGTCAGATTAGGCTAC
GTACTTGCCCGGAGGCTTACGTGGAGCTTA|CGTGCTCTTCTTAATGGTTGGCTTGACCTC
CGGTGACCCCCCTATCACTCTACCCGCGCC|CGAGCGCCCTCCTCGCTAAAAGGATGACGC
GAGGCTTACGTGGAGGCTTACGTGGAGCTT|CAATCCATTTAGAATACCTCATCGAGATCG
ACTAGCCAGACGCGGCGCGGCTCGTATTAC|TTCCTGGATGTCAAAGAGGCACTTAAAGGA
ATTTAGGGACTTAGTTACTAAACGGAGGCT|ATAGTAGTGAATTTGTGAAGCGAGCGATCC
CTCGTCCGTGCTCTTCTTAATGGTTGGCTT|AGTGGTTTCAGTCGTCGCTTTAGGATCTAT
TTTCAGGAGGCTTACGTGGAGCTTAGTGGT|AAGTGGTAGTCAAAACCCTACCGGAGGCTT
GGAGGCTTACGTGGAGCTTAGTGGTTTCAG|TTAATGGTTGGCTTGACCTCATGGGAACGC
TTACGTGGAGCTTAGTGGTTTCAGATCCTA|GTTGGCTTGACCTCATGGGAACGCAGCGTA
GGGCCACAGTCCCGTTATGGTCAAACACTT|CTTACGTGGAGCTTAGTGGTTTCAGCGTTT
GGTGCAGACAGAGTTAGAACCGAAAAGTTC|GCACGCCATCCACTCTTTACTTGTATTAAT
TATACAGCCGCCTCGTCCGTGCTCTTCTTA|ACGTGGAGCTTAGTGGTTTCAGTCGTCGCT
TAGCCCGTCGTGGAGGCTTACGTGGAGCTT|GCTTACGTGGAGCTTAGTGGTTTCAGGAGG
CCCTACCGGAGGCTTACGTGGAGCTTAGTG|TCACTCTACCCGCGCCTCGACGCGCTCTAT
AGATCCTAGGTTATCACAAGGGTTACGTCG|GCAGCGTATCACTTATCGAGCGATGATCGT
GAGCTTAGTGGTTTCAGTCGTCGCTTTAGG|GACGCGGCGCGGCTCGTATTACGGGGGAAT
ACACATTTCAACCTAGCCCGTCGTGGAGGC|GGCTTACGTGGAGGCTTACGTGGAGCTTAG
CTCACTCTTACACGTGCTGGGCGTTTCTAA|CTTAGTGGTTTCAGGTGGAGCTTAGTGGTT
CGACATCCACACATTTCAACCTAGCCCGTC|TACTTGGAGGCTTACGTGGAGGCTTACGTG
CCCGTACTTGCCCGGAGGCTTACGTGGAGC|GTCCGTGCTCTTCTTAATGGTTGGCTTGAC
GGTTTCAGGGGAGCTTAGTGGTTTCAGCAC|CTTACGTGGAGCTTAGTGGTTTCAGACGTC
TTTCGCGAGCGCCCTCCTCGCTAAAAGGAT|GCTTACGTGGAGCTTAGTGGTTTCAGCCAT
CTTATCGAGCGATGATCGTTTCGCGAGCGC|CTTAGGGGTCACTAGGAGGCTTACGTGGAG
CGTGGAGCTTAGTGGTTTCAGGAGGCTTAC|ATCGAGATCGACGCGAAGTGGTAGTCAAAA
AGCGCCCTCCTCGCTAAAAGGATGACGCTT|TGGAGCTTAGTGGTTTCAGCCATATCTTTT
GACGTCCCGTACTTGCCCGGAGGCTTACGT|GCCTCGTCCGTGCTCTTCTTAATGGTTGGC
CAGCGTATCACTTATCGAGCGATGATCGTT|CTCGGGACAGCTTAGGGGTCACTAGGAGGC
TTTCAGTGGGGTGCAGACAGAGTTAGAACC|ACACCATATGCACGCCATCCACTCTTTACT
AGTTGGAGGCTTACGGAGGCTTACGTGGAG|AGCTTAGTGGTTTCAGGGGAGCTTAGTGGT
CTCTACCCGCGCCTCGACGCGCTCTATACA|AAAAGGATGACGCTTCGGAGGCTTACGTGG
TGGTTTCAGCGTTTTACTATCGTATCGGTC|CGACCGCCCCATCTCGCGATGCGCGTTATG
GGTTTCAGCCATATCTTTTCAACGGACTAG|GTCCCGTTATGGTCAAACACTTGGCTTCCT
GGAGCTTAGTGGTTTCAGATCCTAGGTTAT|TTGACCTCATGGGAACGCAGCGTATCACTT
AAGTGAGGAGCTAATCGGGATTTTGTCCGG|CTACTACGTTATTCCGTCTACTCGATACCT
CGGACTAGCCAGACGCGGCGCGGCTCGTAT|GGCTTCCTGGATGTCAAAGAGGCACTTAAA
TTAGTGGTTTCAGTGGGGTGCAGACAGAGT|AATCCAAACACCATATGCACGCCATCCACT
GGATGTCAAAGAGGCACTTAAAGGATAGCC|TATCGGTCCCCCGCCGAACGTCAGATTAGG
GCTTACGTGGAGCTTAGTGGTTTCAGAATA|TTGCCCGGAGGCTTACGTGGAGCTTAGTGG
GCTTAGTGGTTTCAGTTGGAGGCTTACGGA|GAGGCTTACGTGGAGCTTAGTGGTTTCAGG
GGAGCTTAGTGGTTTCAGCCATATCTTTTC|TAGGGCCACAGTCCCGTTATGGTCAAACAC
CAAAACCCTACCGGAGGCTTACGTGGAGCT|CCCTATCACTCTACCCGCGCCTCGACGCGC
GCTTACGTGGAGCTTAGTGGTTTCAGATCC|TGGTTGGCTTGACCTCATGGGAACGCAGCG
GCGTATCACTTATCGAGCGATGATCGTTTC|CGGGACAGCTTAGGGGTCACTAGGAGGCTT
AGAATACCTCATCGAGATCGACGCGAAGTG|GGTTATCACAAGGGTTACGTCGCCTCCGGT
GAGGCTTACGTGGAGCTTAGTGGTTTCAGG|CTAATCGGGATTTTGTCCGGGATTATTTAG
CGCTCTATACAGCCGCCTCGTCCGTGCTCT|GGCTTACGTGGAGCTTAGTGGTTTCAGTCG
CGCTAAAAGGATGACGCTTCGGAGGCTTAC|GGTTTCAGCCATATCTTTTCAACGGACTAG
AGTGGGGTGCAGACAGAGTTAGAACCGAAA|CATATGCACGCCATCCACTCTTTACTTGTA
AGTTACTAAACGGAGGCTTACGTGGAGCTT|TTGTGAAGCGAGCGATCCTACCGGTCGTAT
CCCGCCGAACGTCAGATTAGGCTACTACGT|GGAGGCTTACGTGGAGCTTAGTGGTTTCAG
TTAGTGGTTTCAGTCGTCGCTTTAGGATCT|CGGCGCGGCTCGTATTACGGGGGAATTTAC
TGGGCGTTTCTAACGGGAACAGACGACATC|GAGCTTAGTGGTTTCAGAGGAGATACTTGG
TCCGTGCTCTTCTTAATGGTTGGCTTGACC|GTTTCAGTCGTCGCTTTAGGATCTATCGCC
ATAGCGACCGCCCCATCTCGCGATGCGCGT|TAGAACCGAAAAGTTCGATACCCAAGCGAT
GGGATTATTTAGGGACTTAGTTACTAAACG|CTGATGATAGTAGTGAATTTGTGAAGCGAG
TCAGCCATATCTTTTCAACGGACTAGCCAG|CGTTATGGTCAAACACTTGGCTTCCTGGAT
ACACGTGCTGGGCGTTTCTAACGGGAACAG|TTCAGGTGGAGCTTAGTGGTTTCAGAGGAG
GAGGCTTACGTGGAGCTTAGTGGTTTCAGT|TAATAACTTCGGAAAGGCCACCGGTACCCT
CCTACCGGTCGTATAGCGACCGCCCCATCT|TGCAGACAGAGTTAGAACCGAAAAGTTCGA
CGACGCGCTCTATACAGCCGCCTCGTCCGT|TCGGAGGCTTACGTGGAGCTTAGTGGTTTC
AGTGGTTTCAGAGGAGATACTTGGAGGCTT|GAGCTTAGTGGTTTCAGAATAAACAATCCA
CACTGGCCATCTTAAGGAGGCTTACGTGGA|TGAACCCCGTGAAGTTAATTCGACCCCATC
GAGGCTTACGTGGAGCTTAGTGGTTTCAGA|TAATGGTTGGCTTGACCTCATGGGAACGCA
GTGGAGCTTAGTGGTTTCAGTGACACTGGC|CGGAAAGGCCACCGGTACCCTAGTGAACCC
TCAGGCTGACTTACGCCGAGTTTACTAGGG|TTTAGGGACTTAGTTACTAAACGGAGGCTT
TACCTGATGATAGTAGTGAATTTGTGAAGC|AAGGAGGCTTACGTGGAGCTTAGTGGTTTC
CCGGAGGCTTACGTGGAGCTTAGTGGTTTC|TCTTAATGGTTGGCTTGACCTCATGGGAAC
TGACCTCATGGGAACGCAGCGTATCACTTA|TCGCCCGCATGGAAGCCTCGGGACAGCTTA
GGAGGCTTACGTGGAGCTTAGTGGTTTCAG|TAATTCGACCCCATCCAAATCCAAACACCA
TACGTGGAGCTTAGTGGTTTCAGACGTCCC|CCTCGACGCGCTCTATACAGCCGCCTCGTC
TGACACTGGCCATCTTAAGGAGGCTTACGT|TAGTGAACCCCGTGAAGTTAATTCGACCCC
TTTTCAACGGACTAGCCAGACGCGGCGCGG|AACACTTGGCTTCCTGGATGTCAAAGAGGC
AGCCAGACGCGGCGCGGCTCGTATTACGGG|CTGGATGTCAAAGAGGCACTTAAAGGATAG
TCGACGCGCTCTATACAGCCGCCTCGTCCG|TTCGGAGGCTTACGTGGAGCTTAGTGGTTT
GATTTTGTCCGGGATTATTTAGGGACTTAG|TACTCGATACCTGATGATAGTAGTGAATTT
CAGTCCCGTTATGGTCAAACACTTGGCTTC|TGGAGCTTAGTGGTTTCAGCGTTTTACTAT
GGAGCTTAGTGGTTTCAGCACACGGAGGCT|AGCTTAGTGGTTTCAGACGTCCCGTACTTG
ATCCTAGGTTATCACAAGGGTTACGTCGCC|AGCGTATCACTTATCGAGCGATGATCGTTT
ACAGCCGCCTCGTCCGTGCTCTTCTTAATG|TGGAGCTTAGTGGTTTCAGTCGTCGCTTTA
ATAGCCAAGTGAGGAGCTAATCGGGATTTT|ATTAGGCTACTACGTTATTCCGTCTACTCG
CTACTCGATACCTGATGATAGTAGTGAATT|GCCATCTTAAGGAGGCTTACGTGGAGCTTA
GCCCCATCTCGCGATGCGCGTTATGGGGAG|AAAGTTCGATACCCAAGCGATCCTATGTAA
CCACAGTCCCGTTATGGTCAAACACTTGGC|ACGTGGAGCTTAGTGGTTTCAGCGTTTTAC
CAATCCATTTAGAATACCTCATCGAGATCG|TCAGATCCTAGGTTATCACAAGGGTTACGT
TGATAGTAGTGAATTTGTGAAGCGAGCGAT|CTTACGTGGAGCTTAGTGGTTTCAGTGGGG
CTTACGTGGAGCTTAGTGGTTTCAGATCCT|GGTTGGCTTGACCTCATGGGAACGCAGCGT
TACGTGGAGCTTAGTGGTTTCAGTTGGAGG|GGTTTCAGGAGGCTTACGTGGAGCTTAGTG
CACATTTCAACCTAGCCCGTCGTGGAGGCT|GCTTACGTGGAGGCTTACGTGGAGCTTAGT
GGTTTCAGTTGGAGGCTTACGGAGGCTTAC|ACGTGGAGCTTAGTGGTTTCAGGGGAGCTT
TTTCAACCTAGCCCGTCGTGGAGGCTTACG|ACGTGGAGGCTTACGTGGAGCTTAGTGGTT
GGGACAGCTTAGGGGTCACTAGGAGGCTTA|TAGTGGTTTCAGGCTGACTTACGCCGAGTT
TGGTTTCAGAATAAACAATCCATTTAGAAT|TGGAGCTTAGTGGTTTCAGATCCTAGGTTA
TCACTCTTACACGTGCTGGGCGTTTCTAAC|TTAGTGGTTTCAGGTGGAGCTTAGTGGTTT
TGGAGGCTTACGGAGGCTTACGTGGAGCTT|TTAGTGGTTTCAGGGGAGCTTAGTGGTTTC
CCAAGTGAGGAGCTAATCGGGATTTTGTCC|GGCTACTACGTTATTCCGTCTACTCGATAC
CCATATCTTTTCAACGGACTAGCCAGACGC|ATGGTCAAACACTTGGCTTCCTGGATGTCA
TAGTGGTTTCAGGCTGACTTACGCCGAGTT|CGGGATTATTTAGGGACTTAGTTACTAAAC
GTTTTGCTCACTCTTACACGTGCTGGGCGT|GTGGAGCTTAGTGGTTTCAGGTGGAGCTTA
CCACACATTTCAACCTAGCCCGTCGTGGAG|GAGGCTTACGTGGAGGCTTACGTGGAGCTT
ATCCATTTAGAATACCTCATCGAGATCGAC|AGATCCTAGGTTATCACAAGGGTTACGTCG
GTGACACTGGCCATCTTAAGGAGGCTTACG|CTAGTGAACCCCGTGAAGTTAATTCGACCC
TGGGGAGGCTTACGTGGAGCTTAGTGGTTT|TATGTAATAACTTCGGAAAGGCCACCGGTA
AATTTACTGGGAGGCTTACGTGGAGCTTAG|AAGTGAGGAGCTAATCGGGATTTTGTCCGG
CGGGAACAGACGACATCCACACATTTCAAC|TCAGAGGAGATACTTGGAGGCTTACGTGGA
GGAAGCCTCGGGACAGCTTAGGGGTCACTA|CGTGGAGCTTAGTGGTTTCAGGCTGACTTA
GTTTCAGTGACACTGGCCATCTTAAGGAGG|GGTACCCTAGTGAACCCCGTGAAGTTAATT
GGCTTACGTGGAGCTTAGTGGTTTCAGGCT|AATCGGGATTTTGTCCGGGATTATTTAGGG
TTACTGGGAGGCTTACGTGGAGCTTAGTGG|TGAGGAGCTAATCGGGATTTTGTCCGGGAT
GTCGCTTTAGGATCTATCGCCCGCATGGAA|TACGGGGGAATTTACTGGGAGGCTTACGTG
ACAATCCATTTAGAATACCTCATCGAGATC|TTCAGATCCTAGGTTATCACAAGGGTTACG
TGAGGAGCTAATCGGGATTTTGTCCGGGAT|CTACGTTATTCCGTCTACTCGATACCTGAT
GAGGAGCTAATCGGGATTTTGTCCGGGATT|TACGTTATTCCGTCTACTCGATACCTGATG
AGCGATCCTACCGGTCGTATAGCGACCGCC|GTGGGGTGCAGACAGAGTTAGAACCGAAAA
GCCTCCGGTGACCCCCCTATCACTCTACCC|TTTCGCGAGCGCCCTCCTCGCTAAAAGGAT
ATACAGCCGCCTCGTCCGTGCTCTTCTTAA|CGTGGAGCTTAGTGGTTTCAGTCGTCGCTT
TTAGGGACTTAGTTACTAAACGGAGGCTTA|AGTAGTGAATTTGTGAAGCGAGCGATCCTA
CTTACGTGGAGCTTAGTGGTTTCAGGGGAG|CAAAACCCTACCGGAGGCTTACGTGGAGCT
CGTGGAGCTTAGTGGTTTCAGATCCTAGGT|GGCTTGACCTCATGGGAACGCAGCGTATCA
ACCTCATCGAGATCGACGCGAAGTGGTAGT|TCACAAGGGTTACGTCGCCTCCGGTGACCC
CACACATTTCAACCTAGCCCGTCGTGGAGG|AGGCTTACGTGGAGGCTTACGTGGAGCTTA
GGTTACGTCGCCTCCGGTGACCCCCCTATC|CGATGATCGTTTCGCGAGCGCCCTCCTCGC
ATGGTCAAACACTTGGCTTCCTGGATGTCA|TGGTTTCAGCGTTTTACTATCGTATCGGTC
AGGCTTACGTGGAGCTTAGTGGTTTCAGAT|AATGGTTGGCTTGACCTCATGGGAACGCAG
TTTTGTCCGGGATTATTTAGGGACTTAGTT|CTCGATACCTGATGATAGTAGTGAATTTGT
GGGCGTTTCTAACGGGAACAGACGACATCC|AGCTTAGTGGTTTCAGAGGAGATACTTGGA
TCTTAATGGTTGGCTTGACCTCATGGGAAC|TCGCTTTAGGATCTATCGCCCGCATGGAAG
CAGCCATATCTTTTCAACGGACTAGCCAGA|GTTATGGTCAAACACTTGGCTTCCTGGATG
TACTAAACGGAGGCTTACGTGGAGCTTAGT|TGAAGCGAGCGATCCTACCGGTCGTATAGC
GGCTTCCTGGATGTCAAAGAGGCACTTAAA|TACTATCGTATCGGTCCCCCGCCGAACGTC
GCGTTTTACTATCGTATCGGTCCCCCGCCG|CCATCTCGCGATGCGCGTTATGGGGAGGCT
TACGTGGAGCTTAGTGGTTTCAGGGGAGCT|AAACCCTACCGGAGGCTTACGTGGAGCTTA
AAGCCTCGGGACAGCTTAGGGGTCACTAGG|TGGAGCTTAGTGGTTTCAGGCTGACTTACG
AGGTTATCACAAGGGTTACGTCGCCTCCGG|ATCACTTATCGAGCGATGATCGTTTCGCGA
TTATCGAGCGATGATCGTTTCGCGAGCGCC|TTAGGGGTCACTAGGAGGCTTACGTGGAGC
TTACGGAGGCTTACGTGGAGCTTAGTGGTT|TTTCAGGGGAGCTTAGTGGTTTCAGCACAC
AGAGGCACTTAAAGGATAGCCAAGTGAGGA|CCCGCCGAACGTCAGATTAGGCTACTACGT
AGTGGTTTCAGTCGTCGCTTTAGGATCTAT|GCGCGGCTCGTATTACGGGGGAATTTACTG
GACCTCATGGGAACGCAGCGTATCACTTAT|CGCCCGCATGGAAGCCTCGGGACAGCTTAG
AGTCCCGTTATGGTCAAACACTTGGCTTCC|GGAGCTTAGTGGTTTCAGCGTTTTACTATC
ATGCGCGTTATGGGGAGGCTTACGTGGAGC|CAAGCGATCCTATGTAATAACTTCGGAAAG
CTTAGTGGTTTCAGGGGAGCTTAGTGGTTT|CGGAGGCTTACGTGGAGCTTAGTGGTTTCA
AGCGACCGCCCCATCTCGCGATGCGCGTTA|GAACCGAAAAGTTCGATACCCAAGCGATCC
CCCCCGCCGAACGTCAGATTAGGCTACTAC|GGGGAGGCTTACGTGGAGCTTAGTGGTTTC
GGACTAGCCAGACGCGGCGCGGCTCGTATT|GCTTCCTGGATGTCAAAGAGGCACTTAAAG
CAGAGGAGATACTTGGAGGCTTACGTGGAG|TGGTTTCAGAATAAACAATCCATTTAGAAT
CGCCTCGTCCGTGCTCTTCTTAATGGTTGG|CTTAGTGGTTTCAGTCGTCGCTTTAGGATC
ACCCCCCTATCACTCTACCCGCGCCTCGAC|GCCCTCCTCGCTAAAAGGATGACGCTTCGG
TCTTAAGGAGGCTTACGTGGAGCTTAGTGG|TGAAGTTAATTCGACCCCATCCAAATCCAA
CATCTCGCGATGCGCGTTATGGGGAGGCTT|TTCGATACCCAAGCGATCCTATGTAATAAC
CAGCTTAGGGGTCACTAGGAGGCTTACGTG|GGTTTCAGGCTGACTTACGCCGAGTTTACT
CGCGGCGCGGCTCGTATTACGGGGGAATTT|TCAAAGAGGCACTTAAAGGATAGCCAAGTG
TAGTAGTGAATTTGTGAAGCGAGCGATCCT|ACGTGGAGCTTAGTGGTTTCAGTGGGGTGC
TTCAGAATAAACAATCCATTTAGAATACCT|GCTTAGTGGTTTCAGATCCTAGGTTATCAC
CCTCGACGCGCTCTATACAGCCGCCTCGTC|GCTTCGGAGGCTTACGTGGAGCTTAGTGGT
TCGGGATTTTGTCCGGGATTATTTAGGGAC|CGTCTACTCGATACCTGATGATAGTAGTGA
TCCCGTACTTGCCCGGAGGCTTACGTGGAG|CGTCCGTGCTCTTCTTAATGGTTGGCTTGA
CTGATGATAGTAGTGAATTTGTGAAGCGAG|GAGGCTTACGTGGAGCTTAGTGGTTTCAGT
GGTTTCAGGCTGACTTACGCCGAGTTTACT|ATTATTTAGGGACTTAGTTACTAAACGGAG
GGAGCTTAGTGGTTTCAGTGGGGTGCAGAC|ATCCAAATCCAAACACCATATGCACGCCAT
CGAGATCGACGCGAAGTGGTAGTCAAAACC|GGTTACGTCGCCTCCGGTGACCCCCCTATC
GTGGAGCTTAGTGGTTTCAGCGTTTTACTA|CGGTCGTATAGCGACCGCCCCATCTCGCGA
GCGCCCTCCTCGCTAAAAGGATGACGCTTC|GGAGCTTAGTGGTTTCAGCCATATCTTTTC
TCACTAGGAGGCTTACGTGGAGCTTAGTGG|GACTTACGCCGAGTTTACTAGGGCCACAGT
TCGTCCGTGCTCTTCTTAATGGTTGGCTTG|GTGGTTTCAGTCGTCGCTTTAGGATCTATC
GTCTACTCGATACCTGATGATAGTAGTGAA|TGGCCATCTTAAGGAGGCTTACGTGGAGCT
GTGGTTTCAGGTGGAGCTTAGTGGTTTCAG|GCACACGGAGGCTTACGTGGAGCTTAGTGG
AAAGGATAGCCAAGTGAGGAGCTAATCGGG|GTCAGATTAGGCTACTACGTTATTCCGTCT
TCAGGGGAGCTTAGTGGTTTCAGCACACGG|CGTGGAGCTTAGTGGTTTCAGACGTCCCGT
GTGAATTTGTGAAGCGAGCGATCCTACCGG|GAGCTTAGTGGTTTCAGTGGGGTGCAGACA
ATTCCGTCTACTCGATACCTGATGATAGTA|GACACTGGCCATCTTAAGGAGGCTTACGTG
TGGATGTCAAAGAGGCACTTAAAGGATAGC|GTATCGGTCCCCCGCCGAACGTCAGATTAG
GCCATATCTTTTCAACGGACTAGCCAGACG|TATGGTCAAACACTTGGCTTCCTGGATGTC
GTGGTTTCAGCCATATCTTTTCAACGGACT|CAGTCCCGTTATGGTCAAACACTTGGCTTC
ATTTAGAATACCTCATCGAGATCGACGCGA|CCTAGGTTATCACAAGGGTTACGTCGCCTC
AACGTCAGATTAGGCTACTACGTTATTCCG|TACGTGGAGCTTAGTGGTTTCAGTGACACT
CACACGGAGGCTTACGTGGAGCTTAGTGGT|GTCCCGTACTTGCCCGGAGGCTTACGTGGA
AGACAGAGTTAGAACCGAAAAGTTCGATAC|CCATCCACTCTTTACTTGTATTAATAGTGT
AGCTTAGGGGTCACTAGGAGGCTTACGTGG|GTTTCAGGCTGACTTACGCCGAGTTTACTA
CAGTTGGAGGCTTACGGAGGCTTACGTGGA|GAGCTTAGTGGTTTCAGGGGAGCTTAGTGG
ATCACTCTACCCGCGCCTCGACGCGCTCTA|CGCTAAAAGGATGACGCTTCGGAGGCTTAC
CGGGACAGCTTAGGGGTCACTAGGAGGCTT|TTAGTGGTTTCAGGCTGACTTACGCCGAGT
CTAGGTTATCACAAGGGTTACGTCGCCTCC|GTATCACTTATCGAGCGATGATCGTTTCGC
TCACTTATCGAGCGATGATCGTTTCGCGAG|CAGCTTAGGGGTCACTAGGAGGCTTACGTG
GTATAGCGACCGCCCCATCTCGCGATGCGC|GTTAGAACCGAAAAGTTCGATACCCAAGCG
GTGGAGCTTAGTGGTTTCAGCCATATCTTT|ACTAGGGCCACAGTCCCGTTATGGTCAAAC
TCACAAGGGTTACGTCGCCTCCGGTGACCC|TATCGAGCGATGATCGTTTCGCGAGCGCCC
CGCGAAGTGGTAGTCAAAACCCTACCGGAG|GCCTCCGGTGACCCCCCTATCACTCTACCC
ACGTGGAGGCTTACGTGGAGCTTAGTGGTT|TTTAGAATACCTCATCGAGATCGACGCGAA
GGCACTTAAAGGATAGCCAAGTGAGGAGCT|GCCGAACGTCAGATTAGGCTACTACGTTAT
CTTACGTGGAGCTTAGTGGTTTCAGGCTGA|TCGGGATTTTGTCCGGGATTATTTAGGGAC
TTCAACCTAGCCCGTCGTGGAGGCTTACGT|CGTGGAGGCTTACGTGGAGCTTAGTGGTTT
AGGAGGCTTACGTGGAGCTTAGTGGTTTCA|GGTAGTCAAAACCCTACCGGAGGCTTACGT
GTGGTTTCAGATCCTAGGTTATCACAAGGG|ATGGGAACGCAGCGTATCACTTATCGAGCG
TGATCGTTTCGCGAGCGCCCTCCTCGCTAA|TAGGAGGCTTACGTGGAGCTTAGTGGTTTC
GGAGCTTAGTGGTTTCAGGCTGACTTACGC|TTTGTCCGGGATTATTTAGGGACTTAGTTA
AGCTTAGTGGTTTCAGGTGGAGCTTAGTGG|GTTTCAGCACACGGAGGCTTACGTGGAGCT
TACTGGGAGGCTTACGTGGAGCTTAGTGGT|GAGGAGCTAATCGGGATTTTGTCCGGGATT
TAATCGGGATTTTGTCCGGGATTATTTAGG|TTCCGTCTACTCGATACCTGATGATAGTAG
GGCTTGACCTCATGGGAACGCAGCGTATCA|TCTATCGCCCGCATGGAAGCCTCGGGACAG
GATCCTAGGTTATCACAAGGGTTACGTCGC|CAGCGTATCACTTATCGAGCGATGATCGTT
GTGGTTTCAGGAGGCTTACGTGGAGCTTAG|CGCGAAGTGGTAGTCAAAACCCTACCGGAG
TTCAGATCCTAGGTTATCACAAGGGTTACG|AACGCAGCGTATCACTTATCGAGCGATGAT
GGTAGTCAAAACCCTACCGGAGGCTTACGT|TGACCCCCCTATCACTCTACCCGCGCCTCG
TTAGTGGTTTCAGGTGGAGCTTAGTGGTTT|TCAGCACACGGAGGCTTACGTGGAGCTTAG
ACTTAGTTACTAAACGGAGGCTTACGTGGA|GAATTTGTGAAGCGAGCGATCCTACCGGTC
ATTTACTGGGAGGCTTACGTGGAGCTTAGT|AGTGAGGAGCTAATCGGGATTTTGTCCGGG
TTTCAGTTGGAGGCTTACGGAGGCTTACGT|GTGGAGCTTAGTGGTTTCAGGGGAGCTTAG
GCTTACGTGGAGCTTAGTGGTTTCAGTGGG|TCGACCCCATCCAAATCCAAACACCATATG
TTTACTGGGAGGCTTACGTGGAGCTTAGTG|GTGAGGAGCTAATCGGGATTTTGTCCGGGA
AGCTAATCGGGATTTTGTCCGGGATTATTT|TTATTCCGTCTACTCGATACCTGATGATAG
GAGTTAGAACCGAAAAGTTCGATACCCAAG|CACTCTTTACTTGTATTAATAGTGTACGTA
GTCACTAGGAGGCTTACGTGGAGCTTAGTG|TGACTTACGCCGAGTTTACTAGGGCCACAG
AGTGGTTTCAGTTGGAGGCTTACGGAGGCT|CTTACGTGGAGCTTAGTGGTTTCAGGGGAG
CTCGCGATGCGCGTTATGGGGAGGCTTACG|GATACCCAAGCGATCCTATGTAATAACTTC
ACGTGCTGGGCGTTTCTAACGGGAACAGAC|CAGGTGGAGCTTAGTGGTTTCAGAGGAGAT
CTTACGTGGAGCTTAGTGGTTTCAGACGTC|CGCCTCGACGCGCTCTATACAGCCGCCTCG
AGGGGTCACTAGGAGGCTTACGTGGAGCTT|AGGCTGACTTACGCCGAGTTTACTAGGGCC
TACTCGATACCTGATGATAGTAGTGAATTT|CCATCTTAAGGAGGCTTACGTGGAGCTTAG
AAGAGGCACTTAAAGGATAGCCAAGTGAGG|CCCCGCCGAACGTCAGATTAGGCTACTACG
TGGAGCTTAGTGGTTTCAGGCTGACTTACG|TTTTGTCCGGGATTATTTAGGGACTTAGTT
TAAACGGAGGCTTACGTGGAGCTTAGTGGT|AGCGAGCGATCCTACCGGTCGTATAGCGAC
TTAAAGGATAGCCAAGTGAGGAGCTAATCG|ACGTCAGATTAGGCTACTACGTTATTCCGT
ACCTGATGATAGTAGTGAATTTGTGAAGCG|AGGAGGCTTACGTGGAGCTTAGTGGTTTCA
AGAGGAGATACTTGGAGGCTTACGTGGAGG|GGTTTCAGAATAAACAATCCATTTAGAATA
GGGAACAGACGACATCCACACATTTCAACC|CAGAGGAGATACTTGGAGGCTTACGTGGAG
TTACGTGGAGCTTAGTGGTTTCAGGCTGAC|CGGGATTTTGTCCGGGATTATTTAGGGACT
CTAGGAGGCTTACGTGGAGCTTAGTGGTTT|TTACGCCGAGTTTACTAGGGCCACAGTCCC
TACGCCGAGTTTACTAGGGCCACAGTCCCG|AGTTACTAAACGGAGGCTTACGTGGAGCTT
CTTAGTGGTTTCAGACGTCCCGTACTTGCC|GCTCTATACAGCCGCCTCGTCCGTGCTCTT
ACGTGGAGCTTAGTGGTTTCAGCCATATCT|TTACTAGGGCCACAGTCCCGTTATGGTCAA
TAATGGTTGGCTTGACCTCATGGGAACGCA|CTTTAGGATCTATCGCCCGCATGGAAGCCT
GTGCTCTTCTTAATGGTTGGCTTGACCTCA|TCAGTCGTCGCTTTAGGATCTATCGCCCGC
TTACGTGGAGCTTAGTGGTTTCAGACGTCC|GCCTCGACGCGCTCTATACAGCCGCCTCGT
AGGCTTACGTGGAGGCTTACGTGGAGCTTA|AATCCATTTAGAATACCTCATCGAGATCGA
GCAGCGTATCACTTATCGAGCGATGATCGT|CCTCGGGACAGCTTAGGGGTCACTAGGAGG
TGACCCCCCTATCACTCTACCCGCGCCTCG|GCGCCCTCCTCGCTAAAAGGATGACGCTTC
GCTTAGTGGTTTCAGCGTTTTACTATCGTA|GTATAGCGACCGCCCCATCTCGCGATGCGC
AGCTTAGTGGTTTCAGCCATATCTTTTCAA|GGGCCACAGTCCCGTTATGGTCAAACACTT
AACACTTGGCTTCCTGGATGTCAAAGAGGC|AGCGTTTTACTATCGTATCGGTCCCCCGCC
AAAGAGGCACTTAAAGGATAGCCAAGTGAG|CCCCCGCCGAACGTCAGATTAGGCTACTAC
TGGAGCTTAGTGGTTTCAGCCATATCTTTT|CTAGGGCCACAGTCCCGTTATGGTCAAACA
CTTTAGGATCTATCGCCCGCATGGAAGCCT|GGGGAATTTACTGGGAGGCTTACGTGGAGC
ATCGTATCGGTCCCCCGCCGAACGTCAGAT|ATGCGCGTTATGGGGAGGCTTACGTGGAGC
TCGATACCTGATGATAGTAGTGAATTTGTG|TCTTAAGGAGGCTTACGTGGAGCTTAGTGG
GAGCGCCCTCCTCGCTAAAAGGATGACGCT|GTGGAGCTTAGTGGTTTCAGCCATATCTTT
CTTACGGAGGCTTACGTGGAGCTTAGTGGT|GTTTCAGGGGAGCTTAGTGGTTTCAGCACA
GAGCTTAGTGGTTTCAGTGACACTGGCCAT|AAAGGCCACCGGTACCCTAGTGAACCCCGT
CTGGGCGTTTCTAACGGGAACAGACGACAT|GGAGCTTAGTGGTTTCAGAGGAGATACTTG
GCGACCGCCCCATCTCGCGATGCGCGTTAT|AACCGAAAAGTTCGATACCCAAGCGATCCT
TAGGGGTCACTAGGAGGCTTACGTGGAGCT|CAGGCTGACTTACGCCGAGTTTACTAGGGC
TACGTGGAGCTTAGTGGTTTCAGTGGGGTG|ACCCCATCCAAATCCAAACACCATATGCAC
CCATTTAGAATACCTCATCGAGATCGACGC|ATCCTAGGTTATCACAAGGGTTACGTCGCC
GCGCGTTATGGGGAGGCTTACGTGGAGCTT|AGCGATCCTATGTAATAACTTCGGAAAGGC
CACTCTACCCGCGCCTCGACGCGCTCTATA|CTAAAAGGATGACGCTTCGGAGGCTTACGT
AACAGACGACATCCACACATTTCAACCTAG|AGGAGATACTTGGAGGCTTACGTGGAGGCT
GGAGGCTTACGTGGAGCTTAGTGGTTTCAG|GCGATCCTACCGGTCGTATAGCGACCGCCC
CCTAGCCCGTCGTGGAGGCTTACGTGGAGC|AGGCTTACGTGGAGCTTAGTGGTTTCAGGA
CTTAGTGGTTTCAGAGGAGATACTTGGAGG|GTGGAGCTTAGTGGTTTCAGAATAAACAAT
CGTGGAGCTTAGTGGTTTCAGCCATATCTT|TACTAGGGCCACAGTCCCGTTATGGTCAAA
CTAATCGGGATTTTGTCCGGGATTATTTAG|ATTCCGTCTACTCGATACCTGATGATAGTA
GTTTCAGGAGGCTTACGTGGAGCTTAGTGG|GAAGTGGTAGTCAAAACCCTACCGGAGGCT
TACGTTATTCCGTCTACTCGATACCTGATG|TTCAGTGACACTGGCCATCTTAAGGAGGCT
TGGTTTCAGCCATATCTTTTCAACGGACTA|AGTCCCGTTATGGTCAAACACTTGGCTTCC
TCCACACATTTCAACCTAGCCCGTCGTGGA|GGAGGCTTACGTGGAGGCTTACGTGGAGCT
CGTATCACTTATCGAGCGATGATCGTTTCG|GGGACAGCTTAGGGGTCACTAGGAGGCTTA
AAGCGAGCGATCCTACCGGTCGTATAGCGA|TTTCAGTGGGGTGCAGACAGAGTTAGAACC
TTAGGATCTATCGCCCGCATGGAAGCCTCG|GGAATTTACTGGGAGGCTTACGTGGAGCTT
CGATGCGCGTTATGGGGAGGCTTACGTGGA|CCCAAGCGATCCTATGTAATAACTTCGGAA
TGGAGGCTTACGTGGAGCTTAGTGGTTTCA|AGAATACCTCATCGAGATCGACGCGAAGTG
TCAAACACTTGGCTTCCTGGATGTCAAAGA|TTCAGCGTTTTACTATCGTATCGGTCCCCC
TACGTGGAGCTTAGTGGTTTCAGGAGGCTT|TCATCGAGATCGACGCGAAGTGGTAGTCAA
TTAGTGGTTTCAGAATAAACAATCCATTTA|TACGTGGAGCTTAGTGGTTTCAGATCCTAG
TTTCAGGGGAGCTTAGTGGTTTCAGCACAC|TACGTGGAGCTTAGTGGTTTCAGACGTCCC
GGAGCTTAGTGGTTTCAGGGGAGCTTAGTG|CTACCGGAGGCTTACGTGGAGCTTAGTGGT
GTTTCAGGGGAGCTTAGTGGTTTCAGCACA|TTACGTGGAGCTTAGTGGTTTCAGACGTCC
GAGGCACTTAAAGGATAGCCAAGTGAGGAG|CCGCCGAACGTCAGATTAGGCTACTACGTT
CCCGTTATGGTCAAACACTTGGCTTCCTGG|GCTTAGTGGTTTCAGCGTTTTACTATCGTA
TACGTGGAGCTTAGTGGTTTCAGCGTTTTA|TACCGGTCGTATAGCGACCGCCCCATCTCG
GTGGAGCTTAGTGGTTTCAGAGGAGATACT|GCTTACGTGGAGCTTAGTGGTTTCAGAATA
TAGCCAAGTGAGGAGCTAATCGGGATTTTG|TTAGGCTACTACGTTATTCCGTCTACTCGA
GGAACAGACGACATCCACACATTTCAACCT|AGAGGAGATACTTGGAGGCTTACGTGGAGG
AGGCTTACGTGGAGCTTAGTGGTTTCAGGT|GGGAGCTTAGTGGTTTCAGCACACGGAGGC
TTCAGTCGTCGCTTTAGGATCTATCGCCCG|CTCGTATTACGGGGGAATTTACTGGGAGGC
TCAGTGACACTGGCCATCTTAAGGAGGCTT|ACCCTAGTGAACCCCGTGAAGTTAATTCGA
CCATCTCGCGATGCGCGTTATGGGGAGGCT|GTTCGATACCCAAGCGATCCTATGTAATAA
AAGTGGTAGTCAAAACCCTACCGGAGGCTT|CCGGTGACCCCCCTATCACTCTACCCGCGC
GCTTACGTGGAGCTTAGTGGTTTCAGCGTT|TCCTACCGGTCGTATAGCGACCGCCCCATC
TTAGAACCGAAAAGTTCGATACCCAAGCGA|TCTTTACTTGTATTAATAGTGTACGTACTC
CCGTGCTCTTCTTAATGGTTGGCTTGACCT|TTTCAGTCGTCGCTTTAGGATCTATCGCCC
GGCTTACGTGGAGCTTAGTGGTTTCAGATC|ATGGTTGGCTTGACCTCATGGGAACGCAGC
CAGTGACACTGGCCATCTTAAGGAGGCTTA|CCCTAGTGAACCCCGTGAAGTTAATTCGAC
GTGGTTTCAGGGGAGCTTAGTGGTTTCAGC|GGCTTACGTGGAGCTTAGTGGTTTCAGACG
TTTCAGCCATATCTTTTCAACGGACTAGCC|CCCGTTATGGTCAAACACTTGGCTTCCTGG
TCAACCTAGCCCGTCGTGGAGGCTTACGTG|GTGGAGGCTTACGTGGAGCTTAGTGGTTTC
TCTATACAGCCGCCTCGTCCGTGCTCTTCT|TTACGTGGAGCTTAGTGGTTTCAGTCGTCG
ATCCACACATTTCAACCTAGCCCGTCGTGG|TGGAGGCTTACGTGGAGGCTTACGTGGAGC
TCAGACGTCCCGTACTTGCCCGGAGGCTTA|GCCGCCTCGTCCGTGCTCTTCTTAATGGTT
GTTATTCCGTCTACTCGATACCTGATGATA|AGTGACACTGGCCATCTTAAGGAGGCTTAC
GTCAAAACCCTACCGGAGGCTTACGTGGAG|CCCCCTATCACTCTACCCGCGCCTCGACGC
TCGTCGCTTTAGGATCTATCGCCCGCATGG|ATTACGGGGGAATTTACTGGGAGGCTTACG
AGGTGGAGCTTAGTGGTTTCAGAGGAGATA|AGGCTTACGTGGAGCTTAGTGGTTTCAGAA
GTGGAGGCTTACGTGGAGCTTAGTGGTTTC|TAGAATACCTCATCGAGATCGACGCGAAGT
GAAGCGAGCGATCCTACCGGTCGTATAGCG|GTTTCAGTGGGGTGCAGACAGAGTTAGAAC
GTGGAGCTTAGTGGTTTCAGACGTCCCGTA|CGACGCGCTCTATACAGCCGCCTCGTCCGT
TCAGTGGGGTGCAGACAGAGTTAGAACCGA|ACCATATGCACGCCATCCACTCTTTACTTG
TAGTGGTTTCAGAATAAACAATCCATTTAG|ACGTGGAGCTTAGTGGTTTCAGATCCTAGG
TACGTGGAGCTTAGTGGTTTCAGGTGGAGC|CTTAGTGGTTTCAGCACACGGAGGCTTACG
CTACGTTATTCCGTCTACTCGATACCTGAT|TTTCAGTGACACTGGCCATCTTAAGGAGGC
CCGCCCCATCTCGCGATGCGCGTTATGGGG|GAAAAGTTCGATACCCAAGCGATCCTATGT
GGGACTTAGTTACTAAACGGAGGCTTACGT|AGTGAATTTGTGAAGCGAGCGATCCTACCG
CGTCCCGTACTTGCCCGGAGGCTTACGTGG|CTCGTCCGTGCTCTTCTTAATGGTTGGCTT
TACTTGGAGGCTTACGTGGAGGCTTACGTG|AATAAACAATCCATTTAGAATACCTCATCG
TCGCTAAAAGGATGACGCTTCGGAGGCTTA|TGGTTTCAGCCATATCTTTTCAACGGACTA
AGGGCCACAGTCCCGTTATGGTCAAACACT|GCTTACGTGGAGCTTAGTGGTTTCAGCGTT
CTTGGAGGCTTACGTGGAGGCTTACGTGGA|TAAACAATCCATTTAGAATACCTCATCGAG
GATTAGGCTACTACGTTATTCCGTCTACTC|AGCTTAGTGGTTTCAGTGACACTGGCCATC
AGGAGGCTTACGTGGAGCTTAGTGGTTTCA|TTAATTCGACCCCATCCAAATCCAAACACC
GACATCCACACATTTCAACCTAGCCCGTCG|ACTTGGAGGCTTACGTGGAGGCTTACGTGG
GAATTTGTGAAGCGAGCGATCCTACCGGTC|GCTTAGTGGTTTCAGTGGGGTGCAGACAGA
AAGGAGGCTTACGTGGAGCTTAGTGGTTTC|GTTAATTCGACCCCATCCAAATCCAAACAC
TAAACAATCCATTTAGAATACCTCATCGAG|GGTTTCAGATCCTAGGTTATCACAAGGGTT
GAGGCTTACGTGGAGCTTAGTGGTTTCAGA|TACTTGCCCGGAGGCTTACGTGGAGCTTAG
GGCTTACGTGGAGCTTAGTGGTTTCAGCGT|ATCCTACCGGTCGTATAGCGACCGCCCCAT
CGGCTCGTATTACGGGGGAATTTACTGGGA|GGCACTTAAAGGATAGCCAAGTGAGGAGCT
TACGTGGAGGCTTACGTGGAGCTTAGTGGT|ATTTAGAATACCTCATCGAGATCGACGCGA
CGTACTTGCCCGGAGGCTTACGTGGAGCTT|CCGTGCTCTTCTTAATGGTTGGCTTGACCT
ATGCGTTTTGCTCACTCTTACACGTGCTGG|TTACGTGGAGCTTAGTGGTTTCAGGTGGAG
GATGATAGTAGTGAATTTGTGAAGCGAGCG|GGCTTACGTGGAGCTTAGTGGTTTCAGTGG
AATAAACAATCCATTTAGAATACCTCATCG|GTGGTTTCAGATCCTAGGTTATCACAAGGG
TGGTTTCAGTGGGGTGCAGACAGAGTTAGA|CAAACACCATATGCACGCCATCCACTCTTT
CGTGCTCTTCTTAATGGTTGGCTTGACCTC|TTCAGTCGTCGCTTTAGGATCTATCGCCCG
CTTACACGTGCTGGGCGTTTCTAACGGGAA|GGTTTCAGGTGGAGCTTAGTGGTTTCAGAG
TTCAGGCTGACTTACGCCGAGTTTACTAGG|ATTTAGGGACTTAGTTACTAAACGGAGGCT
TTGACCTCATGGGAACGCAGCGTATCACTT|ATCGCCCGCATGGAAGCCTCGGGACAGCTT
CGCCCGCATGGAAGCCTCGGGACAGCTTAG|GGAGGCTTACGTGGAGCTTAGTGGTTTCAG
GAGCGATGATCGTTTCGCGAGCGCCCTCCT|GGTCACTAGGAGGCTTACGTGGAGCTTAGT
ACGTCAGATTAGGCTACTACGTTATTCCGT|ACGTGGAGCTTAGTGGTTTCAGTGACACTG
TTCGCGAGCGCCCTCCTCGCTAAAAGGATG|CTTACGTGGAGCTTAGTGGTTTCAGCCATA
GGTTTCAGTGGGGTGCAGACAGAGTTAGAA|AAACACCATATGCACGCCATCCACTCTTTA
AACCGAAAAGTTCGATACCCAAGCGATCCT|TACTTGTATTAATAGTGTACGTACTCCCAG
ATTTGTGAAGCGAGCGATCCTACCGGTCGT|TTAGTGGTTTCAGTGGGGTGCAGACAGAGT
GCGCTCTATACAGCCGCCTCGTCCGTGCTC|AGGCTTACGTGGAGCTTAGTGGTTTCAGTC
CGAAGTGGTAGTCAAAACCCTACCGGAGGC|CTCCGGTGACCCCCCTATCACTCTACCCGC
GCACTTAAAGGATAGCCAAGTGAGGAGCTA|CCGAACGTCAGATTAGGCTACTACGTTATT
GGGAGGCTTACGTGGAGCTTAGTGGTTTCA|AGCTAATCGGGATTTTGTCCGGGATTATTT
TTAAGGAGGCTTACGTGGAGCTTAGTGGTT|AAGTTAATTCGACCCCATCCAAATCCAAAC
CTAAAAGGATGACGCTTCGGAGGCTTACGT|TTTCAGCCATATCTTTTCAACGGACTAGCC
TACACGTGCTGGGCGTTTCTAACGGGAACA|TTTCAGGTGGAGCTTAGTGGTTTCAGAGGA
TTAGTGGTTTCAGGGGAGCTTAGTGGTTTC|GGAGGCTTACGTGGAGCTTAGTGGTTTCAG
CCCATCTCGCGATGCGCGTTATGGGGAGGC|AGTTCGATACCCAAGCGATCCTATGTAATA
ACTTGGCTTCCTGGATGTCAAAGAGGCACT|GTTTTACTATCGTATCGGTCCCCCGCCGAA
GCGAGCGATCCTACCGGTCGTATAGCGACC|TCAGTGGGGTGCAGACAGAGTTAGAACCGA
CGTGGAGCTTAGTGGTTTCAGTTGGAGGCT|TTTCAGGAGGCTTACGTGGAGCTTAGTGGT
TATGGGGAGGCTTACGTGGAGCTTAGTGGT|CCTATGTAATAACTTCGGAAAGGCCACCGG
TCAGAGGAGATACTTGGAGGCTTACGTGGA|GTGGTTTCAGAATAAACAATCCATTTAGAA
ATCGGGATTTTGTCCGGGATTATTTAGGGA|CCGTCTACTCGATACCTGATGATAGTAGTG
TTACTATCGTATCGGTCCCCCGCCGAACGT|TCGCGATGCGCGTTATGGGGAGGCTTACGT
TCGGAGGCTTACGTGGAGCTTAGTGGTTTC|TCAACGGACTAGCCAGACGCGGCGCGGCTC
TTCAGCGTTTTACTATCGTATCGGTCCCCC|CGCCCCATCTCGCGATGCGCGTTATGGGGA
CGGAGGCTTACGTGGAGCTTAGTGGTTTCA|CGTACTTGCCCGGAGGCTTACGTGGAGCTT
GAGGCTTACGTGGAGCTTAGTGGTTTCAGG|GGGGAGCTTAGTGGTTTCAGCACACGGAGG
GGGAATTTACTGGGAGGCTTACGTGGAGCT|GCCAAGTGAGGAGCTAATCGGGATTTTGTC
AGGATCTATCGCCCGCATGGAAGCCTCGGG|AATTTACTGGGAGGCTTACGTGGAGCTTAG
AGCTTAGTGGTTTCAGCACACGGAGGCTTA|CTTAGTGGTTTCAGACGTCCCGTACTTGCC
GGGTGCAGACAGAGTTAGAACCGAAAAGTT|TGCACGCCATCCACTCTTTACTTGTATTAA
GCCCGCATGGAAGCCTCGGGACAGCTTAGG|GAGGCTTACGTGGAGCTTAGTGGTTTCAGG
CCCCCCTATCACTCTACCCGCGCCTCGACG|CCCTCCTCGCTAAAAGGATGACGCTTCGGA
AGCTTAGTGGTTTCAGCGTTTTACTATCGT|CGTATAGCGACCGCCCCATCTCGCGATGCG
GAGCTTAGTGGTTTCAGTTGGAGGCTTACG|AGGAGGCTTACGTGGAGCTTAGTGGTTTCA
ACGGGAACAGACGACATCCACACATTTCAA|TTCAGAGGAGATACTTGGAGGCTTACGTGG
TAAAAGGATGACGCTTCGGAGGCTTACGTG|TTCAGCCATATCTTTTCAACGGACTAGCCA
TTAGTGGTTTCAGACGTCCCGTACTTGCCC|CTCTATACAGCCGCCTCGTCCGTGCTCTTC
GCTTAGTGGTTTCAGCACACGGAGGCTTAC|TTAGTGGTTTCAGACGTCCCGTACTTGCCC
CTTAGTGGTTTCAGTCGTCGCTTTAGGATC|GCGGCGCGGCTCGTATTACGGGGGAATTTA
CGCAGCGTATCACTTATCGAGCGATGATCG|GCCTCGGGACAGCTTAGGGGTCACTAGGAG
AGCTTAGTGGTTTCAGGAGGCTTACGTGGA|GATCGACGCGAAGTGGTAGTCAAAACCCTA
AGCTTAGTGGTTTCAGGCTGACTTACGCCG|TGTCCGGGATTATTTAGGGACTTAGTTACT
AGATTAGGCTACTACGTTATTCCGTCTACT|GAGCTTAGTGGTTTCAGTGACACTGGCCAT
CTCGATACCTGATGATAGTAGTGAATTTGT|ATCTTAAGGAGGCTTACGTGGAGCTTAGTG
GGTGACCCCCCTATCACTCTACCCGCGCCT|GAGCGCCCTCCTCGCTAAAAGGATGACGCT
ACGTGGAGCTTAGTGGTTTCAGTCGTCGCT|AGCCAGACGCGGCGCGGCTCGTATTACGGG
TTAGAATACCTCATCGAGATCGACGCGAAG|TAGGTTATCACAAGGGTTACGTCGCCTCCG
GGACAGCTTAGGGGTCACTAGGAGGCTTAC|AGTGGTTTCAGGCTGACTTACGCCGAGTTT
ATCGAGATCGACGCGAAGTGGTAGTCAAAA|AGGGTTACGTCGCCTCCGGTGACCCCCCTA
GATACTTGGAGGCTTACGTGGAGGCTTACG|AGAATAAACAATCCATTTAGAATACCTCAT
TTTACTATCGTATCGGTCCCCCGCCGAACG|CTCGCGATGCGCGTTATGGGGAGGCTTACG
CATTTCAACCTAGCCCGTCGTGGAGGCTTA|TTACGTGGAGGCTTACGTGGAGCTTAGTGG
GTGGTTTCAGACGTCCCGTACTTGCCCGGA|TATACAGCCGCCTCGTCCGTGCTCTTCTTA
TCCCCCGCCGAACGTCAGATTAGGCTACTA|TGGGGAGGCTTACGTGGAGCTTAGTGGTTT
GGTCACTAGGAGGCTTACGTGGAGCTTAGT|CTGACTTACGCCGAGTTTACTAGGGCCACA
AAGGATGACGCTTCGGAGGCTTACGTGGAG|AGCCATATCTTTTCAACGGACTAGCCAGAC
GATAGTAGTGAATTTGTGAAGCGAGCGATC|TTACGTGGAGCTTAGTGGTTTCAGTGGGGT
GCCCTCCTCGCTAAAAGGATGACGCTTCGG|AGCTTAGTGGTTTCAGCCATATCTTTTCAA
CCCCATCTCGCGATGCGCGTTATGGGGAGG|AAGTTCGATACCCAAGCGATCCTATGTAAT
TGGAGCTTAGTGGTTTCAGACGTCCCGTAC|GACGCGCTCTATACAGCCGCCTCGTCCGTG
TTCAACGGACTAGCCAGACGCGGCGCGGCT|CACTTGGCTTCCTGGATGTCAAAGAGGCAC
TTTACTAGGGCCACAGTCCCGTTATGGTCA|ACGGAGGCTTACGTGGAGCTTAGTGGTTTC
GAAAAGTTCGATACCCAAGCGATCCTATGT|TGTATTAATAGTGTACGTACTCCCAGTAAG
CGGGGGAATTTACTGGGAGGCTTACGTGGA|ATAGCCAAGTGAGGAGCTAATCGGGATTTT
AACAATCCATTTAGAATACCTCATCGAGAT|TTTCAGATCCTAGGTTATCACAAGGGTTAC
GGTCAAACACTTGGCTTCCTGGATGTCAAA|GTTTCAGCGTTTTACTATCGTATCGGTCCC
AACGGGAACAGACGACATCCACACATTTCA|TTTCAGAGGAGATACTTGGAGGCTTACGTG
ACCGCCCCATCTCGCGATGCGCGTTATGGG|CGAAAAGTTCGATACCCAAGCGATCCTATG
CGTGCTGGGCGTTTCTAACGGGAACAGACG|AGGTGGAGCTTAGTGGTTTCAGAGGAGATA
GTTTCGCGAGCGCCCTCCTCGCTAAAAGGA|GGCTTACGTGGAGCTTAGTGGTTTCAGCCA
CTTAGTGGTTTCAGCGTTTTACTATCGTAT|TATAGCGACCGCCCCATCTCGCGATGCGCG
GGGAGGCTTACGTGGAGCTTAGTGGTTTCA|TGTAATAACTTCGGAAAGGCCACCGGTACC
ACCTCATGGGAACGCAGCGTATCACTTATC|GCCCGCATGGAAGCCTCGGGACAGCTTAGG
TTAGTGGTTTCAGCCATATCTTTTCAACGG|CCACAGTCCCGTTATGGTCAAACACTTGGC
CCTATCACTCTACCCGCGCCTCGACGCGCT|CCTCGCTAAAAGGATGACGCTTCGGAGGCT
CGCTTTAGGATCTATCGCCCGCATGGAAGC|CGGGGGAATTTACTGGGAGGCTTACGTGGA
CGTCGTGGAGGCTTACGTGGAGCTTAGTGG|CGTGGAGCTTAGTGGTTTCAGGAGGCTTAC
CCGCGCCTCGACGCGCTCTATACAGCCGCC|ATGACGCTTCGGAGGCTTACGTGGAGCTTA
GGTTTCAGAGGAGATACTTGGAGGCTTACG|CTTAGTGGTTTCAGAATAAACAATCCATTT
AGGCTTACGTGGAGCTTAGTGGTTTCAGCG|GATCCTACCGGTCGTATAGCGACCGCCCCA
GGTTTCAGATCCTAGGTTATCACAAGGGTT|GGGAACGCAGCGTATCACTTATCGAGCGAT
TGCGCGTTATGGGGAGGCTTACGTGGAGCT|AAGCGATCCTATGTAATAACTTCGGAAAGG
GAGCTTAGTGGTTTCAGGTGGAGCTTAGTG|GGTTTCAGCACACGGAGGCTTACGTGGAGC
CGAGCGCCCTCCTCGCTAAAAGGATGACGC|CGTGGAGCTTAGTGGTTTCAGCCATATCTT
CTACCCGCGCCTCGACGCGCTCTATACAGC|AAGGATGACGCTTCGGAGGCTTACGTGGAG
GGCTTACGTGGAGCTTAGTGGTTTCAGGTG|GGAGCTTAGTGGTTTCAGCACACGGAGGCT
GCCGCCTCGTCCGTGCTCTTCTTAATGGTT|AGCTTAGTGGTTTCAGTCGTCGCTTTAGGA
TGGGAGGCTTACGTGGAGCTTAGTGGTTTC|GAGCTAATCGGGATTTTGTCCGGGATTATT
GTCCCGTTATGGTCAAACACTTGGCTTCCT|GAGCTTAGTGGTTTCAGCGTTTTACTATCG
TTACGTGGAGCTTAGTGGTTTCAGGTGGAG|GCTTAGTGGTTTCAGCACACGGAGGCTTAC
TCTTCTTAATGGTTGGCTTGACCTCATGGG|TCGTCGCTTTAGGATCTATCGCCCGCATGG
TTACGTGGAGCTTAGTGGTTTCAGTTGGAG|TGGTTTCAGGAGGCTTACGTGGAGCTTAGT
CCAGACGCGGCGCGGCTCGTATTACGGGGG|GGATGTCAAAGAGGCACTTAAAGGATAGCC
AATCGGGATTTTGTCCGGGATTATTTAGGG|TCCGTCTACTCGATACCTGATGATAGTAGT
GTGCTGGGCGTTTCTAACGGGAACAGACGA|GGTGGAGCTTAGTGGTTTCAGAGGAGATAC
TTACGTGGAGCTTAGTGGTTTCAGCCATAT|GTTTACTAGGGCCACAGTCCCGTTATGGTC
TGGAGCTTAGTGGTTTCAGAGGAGATACTT|CTTACGTGGAGCTTAGTGGTTTCAGAATAA
AGCTTAGTGGTTTCAGAATAAACAATCCAT|GCTTACGTGGAGCTTAGTGGTTTCAGATCC
CCGTTATGGTCAAACACTTGGCTTCCTGGA|CTTAGTGGTTTCAGCGTTTTACTATCGTAT
AGAATAAACAATCCATTTAGAATACCTCAT|TAGTGGTTTCAGATCCTAGGTTATCACAAG
TGAAGCGAGCGATCCTACCGGTCGTATAGC|GGTTTCAGTGGGGTGCAGACAGAGTTAGAA
GCCAGACGCGGCGCGGCTCGTATTACGGGG|TGGATGTCAAAGAGGCACTTAAAGGATAGC
TCAACGGACTAGCCAGACGCGGCGCGGCTC|ACTTGGCTTCCTGGATGTCAAAGAGGCACT
CTTACGTGGAGCTTAGTGGTTTCAGTGGGG|CGACCCCATCCAAATCCAAACACCATATGC
GCTTAGTGGTTTCAGGTGGAGCTTAGTGGT|TTTCAGCACACGGAGGCTTACGTGGAGCTT
CGAAAAGTTCGATACCCAAGCGATCCTATG|TTGTATTAATAGTGTACGTACTCCCAGTAA
GGTTTCAGCGTTTTACTATCGTATCGGTCC|GACCGCCCCATCTCGCGATGCGCGTTATGG
TCGCTTTAGGATCTATCGCCCGCATGGAAG|ACGGGGGAATTTACTGGGAGGCTTACGTGG
GCTTAGTGGTTTCAGATCCTAGGTTATCAC|ACCTCATGGGAACGCAGCGTATCACTTATC
CCGGAGGCTTACGTGGAGCTTAGTGGTTTC|CTACCCGCGCCTCGACGCGCTCTATACAGC
GGGAGCTTAGTGGTTTCAGCACACGGAGGC|GAGCTTAGTGGTTTCAGACGTCCCGTACTT
GCGTTTCTAACGGGAACAGACGACATCCAC|CTTAGTGGTTTCAGAGGAGATACTTGGAGG
TTTCAGAGGAGATACTTGGAGGCTTACGTG|TAGTGGTTTCAGAATAAACAATCCATTTAG
ACTAGGGCCACAGTCCCGTTATGGTCAAAC|GAGGCTTACGTGGAGCTTAGTGGTTTCAGC
ACGGAGGCTTACGTGGAGCTTAGTGGTTTC|GAGCGATCCTACCGGTCGTATAGCGACCGC
AAAAGTTCGATACCCAAGCGATCCTATGTA|GTATTAATAGTGTACGTACTCCCAGTAAGA
TCGCCCGCATGGAAGCCTCGGGACAGCTTA|GGGAGGCTTACGTGGAGCTTAGTGGTTTCA
GCTTAGGGGTCACTAGGAGGCTTACGTGGA|TTTCAGGCTGACTTACGCCGAGTTTACTAG
CGGTCCCCCGCCGAACGTCAGATTAGGCTA|TTATGGGGAGGCTTACGTGGAGCTTAGTGG
GTTTCAGAGGAGATACTTGGAGGCTTACGT|TTAGTGGTTTCAGAATAAACAATCCATTTA
ATCGTTTCGCGAGCGCCCTCCTCGCTAAAA|GGAGGCTTACGTGGAGCTTAGTGGTTTCAG
CAACCTAGCCCGTCGTGGAGGCTTACGTGG|TGGAGGCTTACGTGGAGCTTAGTGGTTTCA
TTCAGCACACGGAGGCTTACGTGGAGCTTA|CAGACGTCCCGTACTTGCCCGGAGGCTTAC
GCCACAGTCCCGTTATGGTCAAACACTTGG|TACGTGGAGCTTAGTGGTTTCAGCGTTTTA
CTGGGAGGCTTACGTGGAGCTTAGTGGTTT|GGAGCTAATCGGGATTTTGTCCGGGATTAT
ATTTTGTCCGGGATTATTTAGGGACTTAGT|ACTCGATACCTGATGATAGTAGTGAATTTG
AAAGGATGACGCTTCGGAGGCTTACGTGGA|CAGCCATATCTTTTCAACGGACTAGCCAGA
GGTTTCAGAATAAACAATCCATTTAGAATA|GGAGCTTAGTGGTTTCAGATCCTAGGTTAT
TCGTTTCGCGAGCGCCCTCCTCGCTAAAAG|GAGGCTTACGTGGAGCTTAGTGGTTTCAGC
ATCTATCGCCCGCATGGAAGCCTCGGGACA|TTACTGGGAGGCTTACGTGGAGCTTAGTGG
ACCGGAGGCTTACGTGGAGCTTAGTGGTTT|TCTACCCGCGCCTCGACGCGCTCTATACAG
AGCTTAGTGGTTTCAGACGTCCCGTACTTG|GCGCTCTATACAGCCGCCTCGTCCGTGCTC
TAACGGGAACAGACGACATCCACACATTTC|GTTTCAGAGGAGATACTTGGAGGCTTACGT
ACGGGGGAATTTACTGGGAGGCTTACGTGG|GATAGCCAAGTGAGGAGCTAATCGGGATTT
TCAGAATAAACAATCCATTTAGAATACCTC|CTTAGTGGTTTCAGATCCTAGGTTATCACA
GTGGAGGCTTACGTGGAGCTTAGTGGTTTC|GAGCTTAGTGGTTTCAGGAGGCTTACGTGG
TCAGCGTTTTACTATCGTATCGGTCCCCCG|GCCCCATCTCGCGATGCGCGTTATGGGGAG
AGTTCGATACCCAAGCGATCCTATGTAATA|TTAATAGTGTACGTACTCCCAGTAAGACAT
GGAGGCTTACGTGGAGCTTAGTGGTTTCAG|CGCCGAGTTTACTAGGGCCACAGTCCCGTT
GACACTGGCCATCTTAAGGAGGCTTACGTG|AGTGAACCCCGTGAAGTTAATTCGACCCCA
TTATGGGGAGGCTTACGTGGAGCTTAGTGG|TCCTATGTAATAACTTCGGAAAGGCCACCG
TGGAGCTTAGTGGTTTCAGGAGGCTTACGT|CGAGATCGACGCGAAGTGGTAGTCAAAACC
GCTTACGTGGAGCTTAGTGGTTTCAGGCTG|ATCGGGATTTTGTCCGGGATTATTTAGGGA
AGTGGTTTCAGCACACGGAGGCTTACGTGG|TGGTTTCAGACGTCCCGTACTTGCCCGGAG
CAGACGCGGCGCGGCTCGTATTACGGGGGA|GATGTCAAAGAGGCACTTAAAGGATAGCCA
AGCTTAGTGGTTTCAGATCCTAGGTTATCA|GACCTCATGGGAACGCAGCGTATCACTTAT
CTTACGTGGAGCTTAGTGGTTTCAGTTGGA|GTGGTTTCAGGAGGCTTACGTGGAGCTTAG
TTCAGTTGGAGGCTTACGGAGGCTTACGTG|TGGAGCTTAGTGGTTTCAGGGGAGCTTAGT
TCGCCTCCGGTGACCCCCCTATCACTCTAC|CGTTTCGCGAGCGCCCTCCTCGCTAAAAGG
TCTACTCGATACCTGATGATAGTAGTGAAT|GGCCATCTTAAGGAGGCTTACGTGGAGCTT
GTTAGAACCGAAAAGTTCGATACCCAAGCG|CTCTTTACTTGTATTAATAGTGTACGTACT
GGCGCGGCTCGTATTACGGGGGAATTTACT|AAGAGGCACTTAAAGGATAGCCAAGTGAGG
TTAATGGTTGGCTTGACCTCATGGGAACGC|GCTTTAGGATCTATCGCCCGCATGGAAGCC
GGCTTACGTGGAGCTTAGTGGTTTCAGCCA|CGAGTTTACTAGGGCCACAGTCCCGTTATG
GCCAAGTGAGGAGCTAATCGGGATTTTGTC|AGGCTACTACGTTATTCCGTCTACTCGATA
TACAGCCGCCTCGTCCGTGCTCTTCTTAAT|GTGGAGCTTAGTGGTTTCAGTCGTCGCTTT
GACGCTTCGGAGGCTTACGTGGAGCTTAGT|ATCTTTTCAACGGACTAGCCAGACGCGGCG
CTTACGTGGAGCTTAGTGGTTTCAGGAGGC|CCTCATCGAGATCGACGCGAAGTGGTAGTC
GCTGACTTACGCCGAGTTTACTAGGGCCAC|GGGACTTAGTTACTAAACGGAGGCTTACGT
TAGTGGTTTCAGAGGAGATACTTGGAGGCT|GGAGCTTAGTGGTTTCAGAATAAACAATCC
GTGGTTTCAGTGGGGTGCAGACAGAGTTAG|CCAAACACCATATGCACGCCATCCACTCTT
AAGGGTTACGTCGCCTCCGGTGACCCCCCT|GAGCGATGATCGTTTCGCGAGCGCCCTCCT
TGCTCTTCTTAATGGTTGGCTTGACCTCAT|CAGTCGTCGCTTTAGGATCTATCGCCCGCA
ACGTGGAGCTTAGTGGTTTCAGGGGAGCTT|AACCCTACCGGAGGCTTACGTGGAGCTTAG
TTTCAGTCGTCGCTTTAGGATCTATCGCCC|GCTCGTATTACGGGGGAATTTACTGGGAGG
ATAGTAGTGAATTTGTGAAGCGAGCGATCC|TACGTGGAGCTTAGTGGTTTCAGTGGGGTG
GAATAAACAATCCATTTAGAATACCTCATC|AGTGGTTTCAGATCCTAGGTTATCACAAGG
CTTACGTGGAGGCTTACGTGGAGCTTAGTG|CCATTTAGAATACCTCATCGAGATCGACGC
GCAGACAGAGTTAGAACCGAAAAGTTCGAT|CGCCATCCACTCTTTACTTGTATTAATAGT
GAACCGAAAAGTTCGATACCCAAGCGATCC|TTACTTGTATTAATAGTGTACGTACTCCCA
CAGCACACGGAGGCTTACGTGGAGCTTAGT|GACGTCCCGTACTTGCCCGGAGGCTTACGT
TAGGTTATCACAAGGGTTACGTCGCCTCCG|TATCACTTATCGAGCGATGATCGTTTCGCG
TTTGTGAAGCGAGCGATCCTACCGGTCGTA|TAGTGGTTTCAGTGGGGTGCAGACAGAGTT
GCATGGAAGCCTCGGGACAGCTTAGGGGTC|CTTACGTGGAGCTTAGTGGTTTCAGGCTGA
TTCAGAGGAGATACTTGGAGGCTTACGTGG|AGTGGTTTCAGAATAAACAATCCATTTAGA
TCCCGTTATGGTCAAACACTTGGCTTCCTG|AGCTTAGTGGTTTCAGCGTTTTACTATCGT
ACGGACTAGCCAGACGCGGCGCGGCTCGTA|TGGCTTCCTGGATGTCAAAGAGGCACTTAA
TGGAGCTTAGTGGTTTCAGTGACACTGGCC|GGAAAGGCCACCGGTACCCTAGTGAACCCC
GTCAGATTAGGCTACTACGTTATTCCGTCT|GTGGAGCTTAGTGGTTTCAGTGACACTGGC
TATCGCCCGCATGGAAGCCTCGGGACAGCT|CTGGGAGGCTTACGTGGAGCTTAGTGGTTT
CGTGGAGCTTAGTGGTTTCAGACGTCCCGT|TCGACGCGCTCTATACAGCCGCCTCGTCCG
GAACAGACGACATCCACACATTTCAACCTA|GAGGAGATACTTGGAGGCTTACGTGGAGGC
AGCGATGATCGTTTCGCGAGCGCCCTCCTC|GTCACTAGGAGGCTTACGTGGAGCTTAGTG
TGGTTGGCTTGACCTCATGGGAACGCAGCG|TAGGATCTATCGCCCGCATGGAAGCCTCGG
GCACACGGAGGCTTACGTGGAGCTTAGTGG|CGTCCCGTACTTGCCCGGAGGCTTACGTGG
TTACGTGGAGGCTTACGTGGAGCTTAGTGG|CATTTAGAATACCTCATCGAGATCGACGCG
CATCCACACATTTCAACCTAGCCCGTCGTG|TTGGAGGCTTACGTGGAGGCTTACGTGGAG
CGGAGGCTTACGTGGAGCTTAGTGGTTTCA|TACCCGCGCCTCGACGCGCTCTATACAGCC
CGGAGGCTTACGTGGAGCTTAGTGGTTTCA|CAGGGGAGCTTAGTGGTTTCAGCACACGGA
TGGGAACGCAGCGTATCACTTATCGAGCGA|ATGGAAGCCTCGGGACAGCTTAGGGGTCAC
GTTACGTCGCCTCCGGTGACCCCCCTATCA|GATGATCGTTTCGCGAGCGCCCTCCTCGCT
TTACACGTGCTGGGCGTTTCTAACGGGAAC|GTTTCAGGTGGAGCTTAGTGGTTTCAGAGG
TCGGGACAGCTTAGGGGTCACTAGGAGGCT|CTTAGTGGTTTCAGGCTGACTTACGCCGAG
GAGCTTAGTGGTTTCAGCCATATCTTTTCA|AGGGCCACAGTCCCGTTATGGTCAAACACT
GAGGCTTACGTGGAGCTTAGTGGTTTCAGG|AATACCTCATCGAGATCGACGCGAAGTGGT
CCTGGATGTCAAAGAGGCACTTAAAGGATA|TCGTATCGGTCCCCCGCCGAACGTCAGATT
TAAGGAGGCTTACGTGGAGCTTAGTGGTTT|AGTTAATTCGACCCCATCCAAATCCAAACA
ACCCTACCGGAGGCTTACGTGGAGCTTAGT|ATCACTCTACCCGCGCCTCGACGCGCTCTA
GTGGTTTCAGTTGGAGGCTTACGGAGGCTT|TTACGTGGAGCTTAGTGGTTTCAGGGGAGC
GAGATACTTGGAGGCTTACGTGGAGGCTTA|TCAGAATAAACAATCCATTTAGAATACCTC
GCTACTACGTTATTCCGTCTACTCGATACC|GTGGTTTCAGTGACACTGGCCATCTTAAGG
GCGTTATGGGGAGGCTTACGTGGAGCTTAG|CGATCCTATGTAATAACTTCGGAAAGGCCA
TTTCAGCACACGGAGGCTTACGTGGAGCTT|TCAGACGTCCCGTACTTGCCCGGAGGCTTA
GGCCACAGTCCCGTTATGGTCAAACACTTG|TTACGTGGAGCTTAGTGGTTTCAGCGTTTT
TTCAGGAGGCTTACGTGGAGCTTAGTGGTT|AGTGGTAGTCAAAACCCTACCGGAGGCTTA
CAAGGGTTACGTCGCCTCCGGTGACCCCCC|CGAGCGATGATCGTTTCGCGAGCGCCCTCC
TACTAGGGCCACAGTCCCGTTATGGTCAAA|GGAGGCTTACGTGGAGCTTAGTGGTTTCAG
TACCGGTCGTATAGCGACCGCCCCATCTCG|CAGACAGAGTTAGAACCGAAAAGTTCGATA
CGGTCGTATAGCGACCGCCCCATCTCGCGA|ACAGAGTTAGAACCGAAAAGTTCGATACCC
GATCGTTTCGCGAGCGCCCTCCTCGCTAAA|AGGAGGCTTACGTGGAGCTTAGTGGTTTCA
AGCGTTTTACTATCGTATCGGTCCCCCGCC|CCCATCTCGCGATGCGCGTTATGGGGAGGC
CCTCATCGAGATCGACGCGAAGTGGTAGTC|CACAAGGGTTACGTCGCCTCCGGTGACCCC
TAGAATACCTCATCGAGATCGACGCGAAGT|AGGTTATCACAAGGGTTACGTCGCCTCCGG
ACTTGGAGGCTTACGTGGAGGCTTACGTGG|ATAAACAATCCATTTAGAATACCTCATCGA
GGAGCTTAGTGGTTTCAGTCGTCGCTTTAG|AGACGCGGCGCGGCTCGTATTACGGGGGAA
GGCCATCTTAAGGAGGCTTACGTGGAGCTT|CCCCGTGAAGTTAATTCGACCCCATCCAAA
CGCGTTATGGGGAGGCTTACGTGGAGCTTA|GCGATCCTATGTAATAACTTCGGAAAGGCC
AGGCTTACGTGGAGCTTAGTGGTTTCAGTG|AATAACTTCGGAAAGGCCACCGGTACCCTA
TGGTTTCAGTTGGAGGCTTACGGAGGCTTA|TACGTGGAGCTTAGTGGTTTCAGGGGAGCT
CACGTGCTGGGCGTTTCTAACGGGAACAGA|TCAGGTGGAGCTTAGTGGTTTCAGAGGAGA
AGACGCGGCGCGGCTCGTATTACGGGGGAA|ATGTCAAAGAGGCACTTAAAGGATAGCCAA
CTTAAGGAGGCTTACGTGGAGCTTAGTGGT|GAAGTTAATTCGACCCCATCCAAATCCAAA
GGAGATACTTGGAGGCTTACGTGGAGGCTT|TTCAGAATAAACAATCCATTTAGAATACCT
GTGGTTTCAGTCGTCGCTTTAGGATCTATC|CGCGGCTCGTATTACGGGGGAATTTACTGG
TTCCGTCTACTCGATACCTGATGATAGTAG|ACACTGGCCATCTTAAGGAGGCTTACGTGG
TGGTCAAACACTTGGCTTCCTGGATGTCAA|GGTTTCAGCGTTTTACTATCGTATCGGTCC
AATCCATTTAGAATACCTCATCGAGATCGA|CAGATCCTAGGTTATCACAAGGGTTACGTC
TTTAGGATCTATCGCCCGCATGGAAGCCTC|GGGAATTTACTGGGAGGCTTACGTGGAGCT
AGATCGACGCGAAGTGGTAGTCAAAACCCT|TTACGTCGCCTCCGGTGACCCCCCTATCAC
AGTTAGAACCGAAAAGTTCGATACCCAAGC|ACTCTTTACTTGTATTAATAGTGTACGTAC
GTGGTTTCAGAGGAGATACTTGGAGGCTTA|AGCTTAGTGGTTTCAGAATAAACAATCCAT
TTACGTGGAGCTTAGTGGTTTCAGTGGGGT|GACCCCATCCAAATCCAAACACCATATGCA
GAGCTTAGTGGTTTCAGGGGAGCTTAGTGG|TACCGGAGGCTTACGTGGAGCTTAGTGGTT
CGTATAGCGACCGCCCCATCTCGCGATGCG|AGTTAGAACCGAAAAGTTCGATACCCAAGC
GTTTCAGCCATATCTTTTCAACGGACTAGC|TCCCGTTATGGTCAAACACTTGGCTTCCTG
ACCTAGCCCGTCGTGGAGGCTTACGTGGAG|GAGGCTTACGTGGAGCTTAGTGGTTTCAGG
GAGATCGACGCGAAGTGGTAGTCAAAACCC|GTTACGTCGCCTCCGGTGACCCCCCTATCA
AGGCTTACGTGGAGCTTAGTGGTTTCAGGG|AGTCAAAACCCTACCGGAGGCTTACGTGGA
TCTAACGGGAACAGACGACATCCACACATT|TGGTTTCAGAGGAGATACTTGGAGGCTTAC
AGTGGTTTCAGTGACACTGGCCATCTTAAG|CACCGGTACCCTAGTGAACCCCGTGAAGTT
AGGCTTACGTGGAGCTTAGTGGTTTCAGTC|CGGACTAGCCAGACGCGGCGCGGCTCGTAT
CGTCTACTCGATACCTGATGATAGTAGTGA|CTGGCCATCTTAAGGAGGCTTACGTGGAGC
GCTTCGGAGGCTTACGTGGAGCTTAGTGGT|TTTTCAACGGACTAGCCAGACGCGGCGCGG
TGGTTTCAGATCCTAGGTTATCACAAGGGT|TGGGAACGCAGCGTATCACTTATCGAGCGA
ATGACGCTTCGGAGGCTTACGTGGAGCTTA|ATATCTTTTCAACGGACTAGCCAGACGCGG
AGGGGAGCTTAGTGGTTTCAGCACACGGAG|TGGAGCTTAGTGGTTTCAGACGTCCCGTAC
ATACCTGATGATAGTAGTGAATTTGTGAAG|TAAGGAGGCTTACGTGGAGCTTAGTGGTTT
GTCGTATAGCGACCGCCCCATCTCGCGATG|AGAGTTAGAACCGAAAAGTTCGATACCCAA
GTGGTTTCAGAATAAACAATCCATTTAGAA|GTGGAGCTTAGTGGTTTCAGATCCTAGGTT
ATTAGGCTACTACGTTATTCCGTCTACTCG|GCTTAGTGGTTTCAGTGACACTGGCCATCT
GAAGTGGTAGTCAAAACCCTACCGGAGGCT|TCCGGTGACCCCCCTATCACTCTACCCGCG
GCCGAGTTTACTAGGGCCACAGTCCCGTTA|TACTAAACGGAGGCTTACGTGGAGCTTAGT
GCCTCGACGCGCTCTATACAGCCGCCTCGT|CGCTTCGGAGGCTTACGTGGAGCTTAGTGG
AGGATAGCCAAGTGAGGAGCTAATCGGGAT|CAGATTAGGCTACTACGTTATTCCGTCTAC
TTCAGGTGGAGCTTAGTGGTTTCAGAGGAG|CGGAGGCTTACGTGGAGCTTAGTGGTTTCA
GTTGGCTTGACCTCATGGGAACGCAGCGTA|GGATCTATCGCCCGCATGGAAGCCTCGGGA
CGGAGGCTTACGTGGAGCTTAGTGGTTTCA|CAACGGACTAGCCAGACGCGGCGCGGCTCG
AGTGAATTTGTGAAGCGAGCGATCCTACCG|GGAGCTTAGTGGTTTCAGTGGGGTGCAGAC
TAGGAGGCTTACGTGGAGCTTAGTGGTTTC|TACGCCGAGTTTACTAGGGCCACAGTCCCG
CAAGTGAGGAGCTAATCGGGATTTTGTCCG|GCTACTACGTTATTCCGTCTACTCGATACC
ACGTGGAGCTTAGTGGTTTCAGTTGGAGGC|GTTTCAGGAGGCTTACGTGGAGCTTAGTGG
GCTTACGTGGAGCTTAGTGGTTTCAGGGGA|TCAAAACCCTACCGGAGGCTTACGTGGAGC
TACTATCGTATCGGTCCCCCGCCGAACGTC|CGCGATGCGCGTTATGGGGAGGCTTACGTG
CTCTTCTTAATGGTTGGCTTGACCTCATGG|GTCGTCGCTTTAGGATCTATCGCCCGCATG
CAGCGTTTTACTATCGTATCGGTCCCCCGC|CCCCATCTCGCGATGCGCGTTATGGGGAGG
TTTAGGGACTTAGTTACTAAACGGAGGCTT|TAGTAGTGAATTTGTGAAGCGAGCGATCCT
GGAGGCTTACGTGGAGCTTAGTGGTTTCAG|GTAATAACTTCGGAAAGGCCACCGGTACCC
GGGAACGCAGCGTATCACTTATCGAGCGAT|TGGAAGCCTCGGGACAGCTTAGGGGTCACT
TACGGGGGAATTTACTGGGAGGCTTACGTG|GGATAGCCAAGTGAGGAGCTAATCGGGATT
TTACGTGGAGCTTAGTGGTTTCAGCGTTTT|CTACCGGTCGTATAGCGACCGCCCCATCTC
GGTGGAGCTTAGTGGTTTCAGAGGAGATAC|GGCTTACGTGGAGCTTAGTGGTTTCAGAAT
GGTTTCAGTGACACTGGCCATCTTAAGGAG|CGGTACCCTAGTGAACCCCGTGAAGTTAAT
ACTATCGTATCGGTCCCCCGCCGAACGTCA|GCGATGCGCGTTATGGGGAGGCTTACGTGG
TTATTCCGTCTACTCGATACCTGATGATAG|GTGACACTGGCCATCTTAAGGAGGCTTACG
CTTAGTGGTTTCAGGCTGACTTACGCCGAG|TCCGGGATTATTTAGGGACTTAGTTACTAA
ACGTGGAGCTTAGTGGTTTCAGAATAAACA|CCGGAGGCTTACGTGGAGCTTAGTGGTTTC
TGGGGTGCAGACAGAGTTAGAACCGAAAAG|TATGCACGCCATCCACTCTTTACTTGTATT
GCCCGGAGGCTTACGTGGAGCTTAGTGGTT|CTTCTTAATGGTTGGCTTGACCTCATGGGA
GTCCGGGATTATTTAGGGACTTAGTTACTA|ATACCTGATGATAGTAGTGAATTTGTGAAG
GCTTCCTGGATGTCAAAGAGGCACTTAAAG|ACTATCGTATCGGTCCCCCGCCGAACGTCA
TTGGAGGCTTACGTGGAGGCTTACGTGGAG|AAACAATCCATTTAGAATACCTCATCGAGA
TTACGCCGAGTTTACTAGGGCCACAGTCCC|TAGTTACTAAACGGAGGCTTACGTGGAGCT
AGGAGATACTTGGAGGCTTACGTGGAGGCT|TTTCAGAATAAACAATCCATTTAGAATACC
TTTAGAATACCTCATCGAGATCGACGCGAA|CTAGGTTATCACAAGGGTTACGTCGCCTCC
TTACGGGGGAATTTACTGGGAGGCTTACGT|AGGATAGCCAAGTGAGGAGCTAATCGGGAT
ACGCAGCGTATCACTTATCGAGCGATGATC|AGCCTCGGGACAGCTTAGGGGTCACTAGGA
GTTACTAAACGGAGGCTTACGTGGAGCTTA|TGTGAAGCGAGCGATCCTACCGGTCGTATA
CGGGATTTTGTCCGGGATTATTTAGGGACT|GTCTACTCGATACCTGATGATAGTAGTGAA
CGAGTTTACTAGGGCCACAGTCCCGTTATG|CTAAACGGAGGCTTACGTGGAGCTTAGTGG
AGTGGTAGTCAAAACCCTACCGGAGGCTTA|CGGTGACCCCCCTATCACTCTACCCGCGCC
AGGCTTACGTGGAGCTTAGTGGTTTCAGAA|ACTTGCCCGGAGGCTTACGTGGAGCTTAGT
AGGCTTACGTGGAGCTTAGTGGTTTCAGTT|TTAGTGGTTTCAGGAGGCTTACGTGGAGCT
TACGTGGAGCTTAGTGGTTTCAGCCATATC|TTTACTAGGGCCACAGTCCCGTTATGGTCA
GGAGCTAATCGGGATTTTGTCCGGGATTAT|CGTTATTCCGTCTACTCGATACCTGATGAT
CTTAGTGGTTTCAGGAGGCTTACGTGGAGC|TCGACGCGAAGTGGTAGTCAAAACCCTACC
AGTCAAAACCCTACCGGAGGCTTACGTGGA|CCCCCCTATCACTCTACCCGCGCCTCGACG
GCTTAGTGGTTTCAGGGGAGCTTAGTGGTT|CCGGAGGCTTACGTGGAGCTTAGTGGTTTC
GAGCTTAGTGGTTTCAGCACACGGAGGCTT|GCTTAGTGGTTTCAGACGTCCCGTACTTGC
TTCTAACGGGAACAGACGACATCCACACAT|GTGGTTTCAGAGGAGATACTTGGAGGCTTA
GCTTACGTGGAGCTTAGTGGTTTCAGCCAT|GAGTTTACTAGGGCCACAGTCCCGTTATGG
TGCGTTTTGCTCACTCTTACACGTGCTGGG|TACGTGGAGCTTAGTGGTTTCAGGTGGAGC
ACGTCGCCTCCGGTGACCCCCCTATCACTC|GATCGTTTCGCGAGCGCCCTCCTCGCTAAA
TCCTGGATGTCAAAGAGGCACTTAAAGGAT|ATCGTATCGGTCCCCCGCCGAACGTCAGAT
CGCGCTCTATACAGCCGCCTCGTCCGTGCT|GAGGCTTACGTGGAGCTTAGTGGTTTCAGT
TTTTACTATCGTATCGGTCCCCCGCCGAAC|TCTCGCGATGCGCGTTATGGGGAGGCTTAC
TTAGTGGTTTCAGATCCTAGGTTATCACAA|CTCATGGGAACGCAGCGTATCACTTATCGA
GGATTTTGTCCGGGATTATTTAGGGACTTA|CTACTCGATACCTGATGATAGTAGTGAATT
TTTCAGCGTTTTACTATCGTATCGGTCCCC|CCGCCCCATCTCGCGATGCGCGTTATGGGG
TCTTACACGTGCTGGGCGTTTCTAACGGGA|TGGTTTCAGGTGGAGCTTAGTGGTTTCAGA
AATACCTCATCGAGATCGACGCGAAGTGGT|TTATCACAAGGGTTACGTCGCCTCCGGTGA
GGATGACGCTTCGGAGGCTTACGTGGAGCT|CCATATCTTTTCAACGGACTAGCCAGACGC
CGAACGTCAGATTAGGCTACTACGTTATTC|CTTACGTGGAGCTTAGTGGTTTCAGTGACA
GGGTTACGTCGCCTCCGGTGACCCCCCTAT|GCGATGATCGTTTCGCGAGCGCCCTCCTCG
GGCTGACTTACGCCGAGTTTACTAGGGCCA|AGGGACTTAGTTACTAAACGGAGGCTTACG
GGCTTACGTGGAGCTTAGTGGTTTCAGTGA|ATAACTTCGGAAAGGCCACCGGTACCCTAG
TTAGTTACTAAACGGAGGCTTACGTGGAGC|ATTTGTGAAGCGAGCGATCCTACCGGTCGT
GAGGAGATACTTGGAGGCTTACGTGGAGGC|GTTTCAGAATAAACAATCCATTTAGAATAC
ACGTGGAGCTTAGTGGTTTCAGTGACACTG|TTCGGAAAGGCCACCGGTACCCTAGTGAAC
TAGTTACTAAACGGAGGCTTACGTGGAGCT|TTTGTGAAGCGAGCGATCCTACCGGTCGTA
GCTTACGTGGAGCTTAGTGGTTTCAGGAGG|ACCTCATCGAGATCGACGCGAAGTGGTAGT
TATTACGGGGGAATTTACTGGGAGGCTTAC|AAAGGATAGCCAAGTGAGGAGCTAATCGGG
CACTTATCGAGCGATGATCGTTTCGCGAGC|AGCTTAGGGGTCACTAGGAGGCTTACGTGG
GGCTCGTATTACGGGGGAATTTACTGGGAG|GCACTTAAAGGATAGCCAAGTGAGGAGCTA
CAGAATAAACAATCCATTTAGAATACCTCA|TTAGTGGTTTCAGATCCTAGGTTATCACAA
TCAGATCCTAGGTTATCACAAGGGTTACGT|ACGCAGCGTATCACTTATCGAGCGATGATC
GTTTCAGCGTTTTACTATCGTATCGGTCCC|ACCGCCCCATCTCGCGATGCGCGTTATGGG
CGTTTCTAACGGGAACAGACGACATCCACA|TTAGTGGTTTCAGAGGAGATACTTGGAGGC
GGGTCACTAGGAGGCTTACGTGGAGCTTAG|GCTGACTTACGCCGAGTTTACTAGGGCCAC
GATGACGCTTCGGAGGCTTACGTGGAGCTT|CATATCTTTTCAACGGACTAGCCAGACGCG
GTCCCCCGCCGAACGTCAGATTAGGCTACT|ATGGGGAGGCTTACGTGGAGCTTAGTGGTT
GTGGTTTCAGCGTTTTACTATCGTATCGGT|GCGACCGCCCCATCTCGCGATGCGCGTTAT
CCCGCATGGAAGCCTCGGGACAGCTTAGGG|AGGCTTACGTGGAGCTTAGTGGTTTCAGGC
TGCAGACAGAGTTAGAACCGAAAAGTTCGA|ACGCCATCCACTCTTTACTTGTATTAATAG
TTTCAGTGACACTGGCCATCTTAAGGAGGC|GTACCCTAGTGAACCCCGTGAAGTTAATTC
AGGCTTACGTGGAGCTTAGTGGTTTCAGTG|ATTCGACCCCATCCAAATCCAAACACCATA
AATGGTTGGCTTGACCTCATGGGAACGCAG|TTTAGGATCTATCGCCCGCATGGAAGCCTC
TCCGTCTACTCGATACCTGATGATAGTAGT|CACTGGCCATCTTAAGGAGGCTTACGTGGA
CAGGCTGACTTACGCCGAGTTTACTAGGGC|TTAGGGACTTAGTTACTAAACGGAGGCTTA
GGCTTACGTGGAGCTTAGTGGTTTCAGTCG|GGACTAGCCAGACGCGGCGCGGCTCGTATT
GGAGCTTAGTGGTTTCAGGAGGCTTACGTG|GAGATCGACGCGAAGTGGTAGTCAAAACCC
TCCGGTGACCCCCCTATCACTCTACCCGCG|CGCGAGCGCCCTCCTCGCTAAAAGGATGAC
CTTGGCTTCCTGGATGTCAAAGAGGCACTT|TTTTACTATCGTATCGGTCCCCCGCCGAAC
AGTGGTTTCAGACGTCCCGTACTTGCCCGG|CTATACAGCCGCCTCGTCCGTGCTCTTCTT
AGTGGTTTCAGAATAAACAATCCATTTAGA|CGTGGAGCTTAGTGGTTTCAGATCCTAGGT
AAACCCTACCGGAGGCTTACGTGGAGCTTA|CTATCACTCTACCCGCGCCTCGACGCGCTC
CGGGATTATTTAGGGACTTAGTTACTAAAC|CCTGATGATAGTAGTGAATTTGTGAAGCGA
GATCTATCGCCCGCATGGAAGCCTCGGGAC|TTTACTGGGAGGCTTACGTGGAGCTTAGTG
GACTTACGCCGAGTTTACTAGGGCCACAGT|ACTTAGTTACTAAACGGAGGCTTACGTGGA
TTCAGACGTCCCGTACTTGCCCGGAGGCTT|AGCCGCCTCGTCCGTGCTCTTCTTAATGGT
TGGTTTCAGCACACGGAGGCTTACGTGGAG|GTTTCAGACGTCCCGTACTTGCCCGGAGGC
CCTGATGATAGTAGTGAATTTGTGAAGCGA|GGAGGCTTACGTGGAGCTTAGTGGTTTCAG
TTAGTGGTTTCAGGCTGACTTACGCCGAGT|CCGGGATTATTTAGGGACTTAGTTACTAAA
CGGAGGCTTACGTGGAGCTTAGTGGTTTCA|CTTAATGGTTGGCTTGACCTCATGGGAACG
GAATTTACTGGGAGGCTTACGTGGAGCTTA|CAAGTGAGGAGCTAATCGGGATTTTGTCCG
GTGGAGCTTAGTGGTTTCAGGCTGACTTAC|ATTTTGTCCGGGATTATTTAGGGACTTAGT
GCGATCCTACCGGTCGTATAGCGACCGCCC|TGGGGTGCAGACAGAGTTAGAACCGAAAAG
CTTCGGAGGCTTACGTGGAGCTTAGTGGTT|TTTCAACGGACTAGCCAGACGCGGCGCGGC
CCGCCTCGTCCGTGCTCTTCTTAATGGTTG|GCTTAGTGGTTTCAGTCGTCGCTTTAGGAT
CAGATTAGGCTACTACGTTATTCCGTCTAC|GGAGCTTAGTGGTTTCAGTGACACTGGCCA
CTCGGGACAGCTTAGGGGTCACTAGGAGGC|GCTTAGTGGTTTCAGGCTGACTTACGCCGA
CGCCCTCCTCGCTAAAAGGATGACGCTTCG|GAGCTTAGTGGTTTCAGCCATATCTTTTCA
TCCTCGCTAAAAGGATGACGCTTCGGAGGC|TAGTGGTTTCAGCCATATCTTTTCAACGGA
GATAGCCAAGTGAGGAGCTAATCGGGATTT|GATTAGGCTACTACGTTATTCCGTCTACTC
GCTTACGTGGAGGCTTACGTGGAGCTTAGT|TCCATTTAGAATACCTCATCGAGATCGACG
TAGTCAAAACCCTACCGGAGGCTTACGTGG|ACCCCCCTATCACTCTACCCGCGCCTCGAC
TGGTAGTCAAAACCCTACCGGAGGCTTACG|GTGACCCCCCTATCACTCTACCCGCGCCTC
AGACGTCCCGTACTTGCCCGGAGGCTTACG|CGCCTCGTCCGTGCTCTTCTTAATGGTTGG
TTTGTCCGGGATTATTTAGGGACTTAGTTA|TCGATACCTGATGATAGTAGTGAATTTGTG
CGTGGAGCTTAGTGGTTTCAGCGTTTTACT|CCGGTCGTATAGCGACCGCCCCATCTCGCG
GGATCTATCGCCCGCATGGAAGCCTCGGGA|ATTTACTGGGAGGCTTACGTGGAGCTTAGT
TAGGGCCACAGTCCCGTTATGGTCAAACAC|GGCTTACGTGGAGCTTAGTGGTTTCAGCGT
ACTTGCCCGGAGGCTTACGTGGAGCTTAGT|TGCTCTTCTTAATGGTTGGCTTGACCTCAT
GTATCGGTCCCCCGCCGAACGTCAGATTAG|CGCGTTATGGGGAGGCTTACGTGGAGCTTA
TCACTCTACCCGCGCCTCGACGCGCTCTAT|GCTAAAAGGATGACGCTTCGGAGGCTTACG
GACCGCCCCATCTCGCGATGCGCGTTATGG|CCGAAAAGTTCGATACCCAAGCGATCCTAT
GCTCACTCTTACACGTGCTGGGCGTTTCTA|GCTTAGTGGTTTCAGGTGGAGCTTAGTGGT
AGTGGTTTCAGATCCTAGGTTATCACAAGG|CATGGGAACGCAGCGTATCACTTATCGAGC
CAGGAGGCTTACGTGGAGCTTAGTGGTTTC|TGGTAGTCAAAACCCTACCGGAGGCTTACG
CTTAGTGGTTTCAGGTGGAGCTTAGTGGTT|TTCAGCACACGGAGGCTTACGTGGAGCTTA
GCGAGCGCCCTCCTCGCTAAAAGGATGACG|ACGTGGAGCTTAGTGGTTTCAGCCATATCT
ATCGACGCGAAGTGGTAGTCAAAACCCTAC|ACGTCGCCTCCGGTGACCCCCCTATCACTC
AGGAGCTAATCGGGATTTTGTCCGGGATTA|ACGTTATTCCGTCTACTCGATACCTGATGA
CCCGTCGTGGAGGCTTACGTGGAGCTTAGT|TACGTGGAGCTTAGTGGTTTCAGGAGGCTT
CCTCGGGACAGCTTAGGGGTCACTAGGAGG|AGCTTAGTGGTTTCAGGCTGACTTACGCCG
ACACGGAGGCTTACGTGGAGCTTAGTGGTT|TCCCGTACTTGCCCGGAGGCTTACGTGGAG
CTAGCCCGTCGTGGAGGCTTACGTGGAGCT|GGCTTACGTGGAGCTTAGTGGTTTCAGGAG
TGGCTTGACCTCATGGGAACGCAGCGTATC|ATCTATCGCCCGCATGGAAGCCTCGGGACA
GAGCTTAGTGGTTTCAGTGGGGTGCAGACA|TCCAAATCCAAACACCATATGCACGCCATC
ACTTATCGAGCGATGATCGTTTCGCGAGCG|GCTTAGGGGTCACTAGGAGGCTTACGTGGA
AGCCCGTCGTGGAGGCTTACGTGGAGCTTA|CTTACGTGGAGCTTAGTGGTTTCAGGAGGC
CACGGAGGCTTACGTGGAGCTTAGTGGTTT|CCCGTACTTGCCCGGAGGCTTACGTGGAGC
TGTGAAGCGAGCGATCCTACCGGTCGTATA|GTGGTTTCAGTGGGGTGCAGACAGAGTTAG
ACGTTATTCCGTCTACTCGATACCTGATGA|TCAGTGACACTGGCCATCTTAAGGAGGCTT
CATGGGAACGCAGCGTATCACTTATCGAGC|GCATGGAAGCCTCGGGACAGCTTAGGGGTC
TTTCAGATCCTAGGTTATCACAAGGGTTAC|GAACGCAGCGTATCACTTATCGAGCGATGA
CCTAGGTTATCACAAGGGTTACGTCGCCTC|CGTATCACTTATCGAGCGATGATCGTTTCG
ATCGCCCGCATGGAAGCCTCGGGACAGCTT|TGGGAGGCTTACGTGGAGCTTAGTGGTTTC
CGTCAGATTAGGCTACTACGTTATTCCGTC|CGTGGAGCTTAGTGGTTTCAGTGACACTGG
CCTCATGGGAACGCAGCGTATCACTTATCG|CCCGCATGGAAGCCTCGGGACAGCTTAGGG
GTGGTAGTCAAAACCCTACCGGAGGCTTAC|GGTGACCCCCCTATCACTCTACCCGCGCCT
TTTCAGAATAAACAATCCATTTAGAATACC|AGCTTAGTGGTTTCAGATCCTAGGTTATCA
CAGTGGGGTGCAGACAGAGTTAGAACCGAA|CCATATGCACGCCATCCACTCTTTACTTGT
TAGTGGTTTCAGGTGGAGCTTAGTGGTTTC|CAGCACACGGAGGCTTACGTGGAGCTTAGT
GATCCTACCGGTCGTATAGCGACCGCCCCA|GGGTGCAGACAGAGTTAGAACCGAAAAGTT
CGTTATGGGGAGGCTTACGTGGAGCTTAGT|GATCCTATGTAATAACTTCGGAAAGGCCAC
TGGAGCTTAGTGGTTTCAGTTGGAGGCTTA|TCAGGAGGCTTACGTGGAGCTTAGTGGTTT
GGGATTTTGTCCGGGATTATTTAGGGACTT|TCTACTCGATACCTGATGATAGTAGTGAAT
ATAAACAATCCATTTAGAATACCTCATCGA|TGGTTTCAGATCCTAGGTTATCACAAGGGT
TGAATTTGTGAAGCGAGCGATCCTACCGGT|AGCTTAGTGGTTTCAGTGGGGTGCAGACAG
ATCACTTATCGAGCGATGATCGTTTCGCGA|ACAGCTTAGGGGTCACTAGGAGGCTTACGT
GTGGAGCTTAGTGGTTTCAGGAGGCTTACG|TCGAGATCGACGCGAAGTGGTAGTCAAAAC
CGTCGCTTTAGGATCTATCGCCCGCATGGA|TTACGGGGGAATTTACTGGGAGGCTTACGT
TCGTATAGCGACCGCCCCATCTCGCGATGC|GAGTTAGAACCGAAAAGTTCGATACCCAAG
GCTTTAGGATCTATCGCCCGCATGGAAGCC|GGGGGAATTTACTGGGAGGCTTACGTGGAG
CAACGGACTAGCCAGACGCGGCGCGGCTCG|CTTGGCTTCCTGGATGTCAAAGAGGCACTT
CGCCCCATCTCGCGATGCGCGTTATGGGGA|AAAAGTTCGATACCCAAGCGATCCTATGTA
GAGGCTTACGGAGGCTTACGTGGAGCTTAG|AGTGGTTTCAGGGGAGCTTAGTGGTTTCAG
AGCCGCCTCGTCCGTGCTCTTCTTAATGGT|GAGCTTAGTGGTTTCAGTCGTCGCTTTAGG
TGGAGCTTAGTGGTTTCAGCGTTTTACTAT|GGTCGTATAGCGACCGCCCCATCTCGCGAT
GCTAAAAGGATGACGCTTCGGAGGCTTACG|GTTTCAGCCATATCTTTTCAACGGACTAGC
TCTATCGCCCGCATGGAAGCCTCGGGACAG|TACTGGGAGGCTTACGTGGAGCTTAGTGGT
TAGTGGTTTCAGACGTCCCGTACTTGCCCG|TCTATACAGCCGCCTCGTCCGTGCTCTTCT
AACGGAGGCTTACGTGGAGCTTAGTGGTTT|CGAGCGATCCTACCGGTCGTATAGCGACCG
AGGAGGCTTACGTGGAGCTTAGTGGTTTCA|ACGCCGAGTTTACTAGGGCCACAGTCCCGT
GTGGAGCTTAGTGGTTTCAGTCGTCGCTTT|CCAGACGCGGCGCGGCTCGTATTACGGGGG
CGACCGCCCCATCTCGCGATGCGCGTTATG|ACCGAAAAGTTCGATACCCAAGCGATCCTA
AGTGGTTTCAGGGGAGCTTAGTGGTTTCAG|AGGCTTACGTGGAGCTTAGTGGTTTCAGAC
GGAGGCTTACGTGGAGGCTTACGTGGAGCT|ACAATCCATTTAGAATACCTCATCGAGATC
TAGTGGTTTCAGTGGGGTGCAGACAGAGTT|ATCCAAACACCATATGCACGCCATCCACTC
AGTGGTTTCAGGCTGACTTACGCCGAGTTT|GGGATTATTTAGGGACTTAGTTACTAAACG
TCAAAACCCTACCGGAGGCTTACGTGGAGC|CCCCTATCACTCTACCCGCGCCTCGACGCG
TCCTAGGTTATCACAAGGGTTACGTCGCCT|GCGTATCACTTATCGAGCGATGATCGTTTC
AGGCTACTACGTTATTCCGTCTACTCGATA|TAGTGGTTTCAGTGACACTGGCCATCTTAA
ACAGAGTTAGAACCGAAAAGTTCGATACCC|ATCCACTCTTTACTTGTATTAATAGTGTAC
AGCGTATCACTTATCGAGCGATGATCGTTT|TCGGGACAGCTTAGGGGTCACTAGGAGGCT
AGTGGTTTCAGGTGGAGCTTAGTGGTTTCA|AGCACACGGAGGCTTACGTGGAGCTTAGTG
TTGCCCGGAGGCTTACGTGGAGCTTAGTGG|CTCTTCTTAATGGTTGGCTTGACCTCATGG
GGCGTTTCTAACGGGAACAGACGACATCCA|GCTTAGTGGTTTCAGAGGAGATACTTGGAG
TTGGAGGCTTACGGAGGCTTACGTGGAGCT|CTTAGTGGTTTCAGGGGAGCTTAGTGGTTT
GGAGGCTTACGTGGAGCTTAGTGGTTTCAG|AGGGGAGCTTAGTGGTTTCAGCACACGGAG
TAGGCTACTACGTTATTCCGTCTACTCGAT|TTAGTGGTTTCAGTGACACTGGCCATCTTA
GAGGCTTACGTGGAGCTTAGTGGTTTCAGA|CCCGCGCCTCGACGCGCTCTATACAGCCGC
TGGAGCTTAGTGGTTTCAGGTGGAGCTTAG|GTGGTTTCAGCACACGGAGGCTTACGTGGA
CGTATTACGGGGGAATTTACTGGGAGGCTT|TTAAAGGATAGCCAAGTGAGGAGCTAATCG
CTTCTTAATGGTTGGCTTGACCTCATGGGA|CGTCGCTTTAGGATCTATCGCCCGCATGGA
GATTATTTAGGGACTTAGTTACTAAACGGA|GATGATAGTAGTGAATTTGTGAAGCGAGCG
GGATTATTTAGGGACTTAGTTACTAAACGG|TGATGATAGTAGTGAATTTGTGAAGCGAGC
GAGTTTACTAGGGCCACAGTCCCGTTATGG|TAAACGGAGGCTTACGTGGAGCTTAGTGGT
GGTTTCAGGTGGAGCTTAGTGGTTTCAGAG|ACACGGAGGCTTACGTGGAGCTTAGTGGTT
AAACAATCCATTTAGAATACCTCATCGAGA|GTTTCAGATCCTAGGTTATCACAAGGGTTA
CCATCTTAAGGAGGCTTACGTGGAGCTTAG|CCGTGAAGTTAATTCGACCCCATCCAAATC
AAACGGAGGCTTACGTGGAGCTTAGTGGTT|GCGAGCGATCCTACCGGTCGTATAGCGACC
CCTACCGGAGGCTTACGTGGAGCTTAGTGG|CACTCTACCCGCGCCTCGACGCGCTCTATA
AGCTTAGTGGTTTCAGTGACACTGGCCATC|AAGGCCACCGGTACCCTAGTGAACCCCGTG
AGTCGTCGCTTTAGGATCTATCGCCCGCAT|GTATTACGGGGGAATTTACTGGGAGGCTTA
CGCTTCGGAGGCTTACGTGGAGCTTAGTGG|CTTTTCAACGGACTAGCCAGACGCGGCGCG
ACTGGGAGGCTTACGTGGAGCTTAGTGGTT|AGGAGCTAATCGGGATTTTGTCCGGGATTA
CTTAGTGGTTTCAGATCCTAGGTTATCACA|CCTCATGGGAACGCAGCGTATCACTTATCG
CCTCGTCCGTGCTCTTCTTAATGGTTGGCT|TAGTGGTTTCAGTCGTCGCTTTAGGATCTA
ACGGAGGCTTACGTGGAGCTTAGTGGTTTC|CCGTACTTGCCCGGAGGCTTACGTGGAGCT
GTGGGGTGCAGACAGAGTTAGAACCGAAAA|ATATGCACGCCATCCACTCTTTACTTGTAT
GCTCTTCTTAATGGTTGGCTTGACCTCATG|AGTCGTCGCTTTAGGATCTATCGCCCGCAT
GCTTACGTGGAGCTTAGTGGTTTCAGTTGG|AGTGGTTTCAGGAGGCTTACGTGGAGCTTA
TCGGTCCCCCGCCGAACGTCAGATTAGGCT|GTTATGGGGAGGCTTACGTGGAGCTTAGTG
GACGCGCTCTATACAGCCGCCTCGTCCGTG|CGGAGGCTTACGTGGAGCTTAGTGGTTTCA
ATATCTTTTCAACGGACTAGCCAGACGCGG|GGTCAAACACTTGGCTTCCTGGATGTCAAA
ACACTGGCCATCTTAAGGAGGCTTACGTGG|GTGAACCCCGTGAAGTTAATTCGACCCCAT
GGCTTACGTGGAGCTTAGTGGTTTCAGACG|CGCGCCTCGACGCGCTCTATACAGCCGCCT
AATTTGTGAAGCGAGCGATCCTACCGGTCG|CTTAGTGGTTTCAGTGGGGTGCAGACAGAG
CTCTTACACGTGCTGGGCGTTTCTAACGGG|GTGGTTTCAGGTGGAGCTTAGTGGTTTCAG
CTCATGGGAACGCAGCGTATCACTTATCGA|CCGCATGGAAGCCTCGGGACAGCTTAGGGG
AGCCTCGGGACAGCTTAGGGGTCACTAGGA|GGAGCTTAGTGGTTTCAGGCTGACTTACGC
CCCGCGCCTCGACGCGCTCTATACAGCCGC|GATGACGCTTCGGAGGCTTACGTGGAGCTT
AGGCTTACGTGGAGCTTAGTGGTTTCAGCC|CCGAGTTTACTAGGGCCACAGTCCCGTTAT
ACCGAAAAGTTCGATACCCAAGCGATCCTA|ACTTGTATTAATAGTGTACGTACTCCCAGT
TATCACAAGGGTTACGTCGCCTCCGGTGAC|CTTATCGAGCGATGATCGTTTCGCGAGCGC
ACATCCACACATTTCAACCTAGCCCGTCGT|CTTGGAGGCTTACGTGGAGGCTTACGTGGA
CTTAGTGGTTTCAGCACACGGAGGCTTACG|TAGTGGTTTCAGACGTCCCGTACTTGCCCG
ATACTTGGAGGCTTACGTGGAGGCTTACGT|GAATAAACAATCCATTTAGAATACCTCATC
GGAGGCTTACGTGGAGCTTAGTGGTTTCAG|GAATACCTCATCGAGATCGACGCGAAGTGG
GGAGGCTTACGTGGAGCTTAGTGGTTTCAG|GCTAATCGGGATTTTGTCCGGGATTATTTA
TGGCCATCTTAAGGAGGCTTACGTGGAGCT|ACCCCGTGAAGTTAATTCGACCCCATCCAA
CCTCGCTAAAAGGATGACGCTTCGGAGGCT|AGTGGTTTCAGCCATATCTTTTCAACGGAC
TTTCTAACGGGAACAGACGACATCCACACA|AGTGGTTTCAGAGGAGATACTTGGAGGCTT
CAGTCGTCGCTTTAGGATCTATCGCCCGCA|CGTATTACGGGGGAATTTACTGGGAGGCTT
TACCGGAGGCTTACGTGGAGCTTAGTGGTT|CTCTACCCGCGCCTCGACGCGCTCTATACA
ATCTTTTCAACGGACTAGCCAGACGCGGCG|TCAAACACTTGGCTTCCTGGATGTCAAAGA
GTCCGTGCTCTTCTTAATGGTTGGCTTGAC|GGTTTCAGTCGTCGCTTTAGGATCTATCGC
CCGAAAAGTTCGATACCCAAGCGATCCTAT|CTTGTATTAATAGTGTACGTACTCCCAGTA
TTCGGAGGCTTACGTGGAGCTTAGTGGTTT|TTCAACGGACTAGCCAGACGCGGCGCGGCT
AGTAGTGAATTTGTGAAGCGAGCGATCCTA|CGTGGAGCTTAGTGGTTTCAGTGGGGTGCA
TACTTGCCCGGAGGCTTACGTGGAGCTTAG|GTGCTCTTCTTAATGGTTGGCTTGACCTCA
AACCTAGCCCGTCGTGGAGGCTTACGTGGA|GGAGGCTTACGTGGAGCTTAGTGGTTTCAG
TCAGTTGGAGGCTTACGGAGGCTTACGTGG|GGAGCTTAGTGGTTTCAGGGGAGCTTAGTG
GGGGAATTTACTGGGAGGCTTACGTGGAGC|AGCCAAGTGAGGAGCTAATCGGGATTTTGT
CGTCCGTGCTCTTCTTAATGGTTGGCTTGA|TGGTTTCAGTCGTCGCTTTAGGATCTATCG
TGGAGCTTAGTGGTTTCAGGGGAGCTTAGT|CCTACCGGAGGCTTACGTGGAGCTTAGTGG
GGTCGTATAGCGACCGCCCCATCTCGCGAT|CAGAGTTAGAACCGAAAAGTTCGATACCCA
ACTCTTACACGTGCTGGGCGTTTCTAACGG|AGTGGTTTCAGGTGGAGCTTAGTGGTTTCA
TGACGCTTCGGAGGCTTACGTGGAGCTTAG|TATCTTTTCAACGGACTAGCCAGACGCGGC
CTTAGTGGTTTCAGTGACACTGGCCATCTT|GGCCACCGGTACCCTAGTGAACCCCGTGAA
GCTTACGGAGGCTTACGTGGAGCTTAGTGG|GGTTTCAGGGGAGCTTAGTGGTTTCAGCAC
TGCTGGGCGTTTCTAACGGGAACAGACGAC|GTGGAGCTTAGTGGTTTCAGAGGAGATACT
CACTTAAAGGATAGCCAAGTGAGGAGCTAA|CGAACGTCAGATTAGGCTACTACGTTATTC
GAGGCTTACGTGGAGCTTAGTGGTTTCAGC|CGATCCTACCGGTCGTATAGCGACCGCCCC
CATGGAAGCCTCGGGACAGCTTAGGGGTCA|TTACGTGGAGCTTAGTGGTTTCAGGCTGAC
GTGACCCCCCTATCACTCTACCCGCGCCTC|AGCGCCCTCCTCGCTAAAAGGATGACGCTT
CGGAGGCTTACGTGGAGCTTAGTGGTTTCA|AGCGATCCTACCGGTCGTATAGCGACCGCC
TTAGTGGTTTCAGTGACACTGGCCATCTTA|GCCACCGGTACCCTAGTGAACCCCGTGAAG
TCAGATTAGGCTACTACGTTATTCCGTCTA|TGGAGCTTAGTGGTTTCAGTGACACTGGCC
GTTGGAGGCTTACGGAGGCTTACGTGGAGC|GCTTAGTGGTTTCAGGGGAGCTTAGTGGTT
GCTTACGTGGAGCTTAGTGGTTTCAGTGAC|TAACTTCGGAAAGGCCACCGGTACCCTAGT
TTTCAGGCTGACTTACGCCGAGTTTACTAG|TATTTAGGGACTTAGTTACTAAACGGAGGC
AGTGGTTTCAGTGGGGTGCAGACAGAGTTA|TCCAAACACCATATGCACGCCATCCACTCT
CTTACGTGGAGCTTAGTGGTTTCAGCGTTT|CCTACCGGTCGTATAGCGACCGCCCCATCT
CTTAGTTACTAAACGGAGGCTTACGTGGAG|AATTTGTGAAGCGAGCGATCCTACCGGTCG
GGAGCTTAGTGGTTTCAGACGTCCCGTACT|ACGCGCTCTATACAGCCGCCTCGTCCGTGC
ACTCTACCCGCGCCTCGACGCGCTCTATAC|TAAAAGGATGACGCTTCGGAGGCTTACGTG
TCGTGGAGGCTTACGTGGAGCTTAGTGGTT|TGGAGCTTAGTGGTTTCAGGAGGCTTACGT
TTACTAAACGGAGGCTTACGTGGAGCTTAG|GTGAAGCGAGCGATCCTACCGGTCGTATAG
CTTACGTGGAGCTTAGTGGTTTCAGCCATA|AGTTTACTAGGGCCACAGTCCCGTTATGGT
CAAACACTTGGCTTCCTGGATGTCAAAGAG|TCAGCGTTTTACTATCGTATCGGTCCCCCG
GAGCTTAGTGGTTTCAGATCCTAGGTTATC|TGACCTCATGGGAACGCAGCGTATCACTTA
ACGTGGAGCTTAGTGGTTTCAGATCCTAGG|TGGCTTGACCTCATGGGAACGCAGCGTATC
CCTCCTCGCTAAAAGGATGACGCTTCGGAG|CTTAGTGGTTTCAGCCATATCTTTTCAACG
CGCGAGCGCCCTCCTCGCTAAAAGGATGAC|TACGTGGAGCTTAGTGGTTTCAGCCATATC
CGTGGAGCTTAGTGGTTTCAGGGGAGCTTA|ACCCTACCGGAGGCTTACGTGGAGCTTAGT
CTTACGTGGAGCTTAGTGGTTTCAGGTGGA|AGCTTAGTGGTTTCAGCACACGGAGGCTTA
GACGCGGCGCGGCTCGTATTACGGGGGAAT|TGTCAAAGAGGCACTTAAAGGATAGCCAAG
GTATCACTTATCGAGCGATGATCGTTTCGC|GGACAGCTTAGGGGTCACTAGGAGGCTTAC
CTCATCGAGATCGACGCGAAGTGGTAGTCA|ACAAGGGTTACGTCGCCTCCGGTGACCCCC
GAGCTTAGTGGTTTCAGACGTCCCGTACTT|CGCGCTCTATACAGCCGCCTCGTCCGTGCT
ATCGGTCCCCCGCCGAACGTCAGATTAGGC|CGTTATGGGGAGGCTTACGTGGAGCTTAGT
GAGCTTAGTGGTTTCAGGAGGCTTACGTGG|AGATCGACGCGAAGTGGTAGTCAAAACCCT
GTTTCAGATCCTAGGTTATCACAAGGGTTA|GGAACGCAGCGTATCACTTATCGAGCGATG
CGCATGGAAGCCTCGGGACAGCTTAGGGGT|GCTTACGTGGAGCTTAGTGGTTTCAGGCTG
GTAGTGAATTTGTGAAGCGAGCGATCCTAC|GTGGAGCTTAGTGGTTTCAGTGGGGTGCAG
TGGAAGCCTCGGGACAGCTTAGGGGTCACT|ACGTGGAGCTTAGTGGTTTCAGGCTGACTT
CAGACAGAGTTAGAACCGAAAAGTTCGATA|GCCATCCACTCTTTACTTGTATTAATAGTG
TAGTGGTTTCAGGGGAGCTTAGTGGTTTCA|GAGGCTTACGTGGAGCTTAGTGGTTTCAGA
GGCTTACGTGGAGCTTAGTGGTTTCAGGGG|GTCAAAACCCTACCGGAGGCTTACGTGGAG
GAGGCTTACGTGGAGCTTAGTGGTTTCAGT|AATTCGACCCCATCCAAATCCAAACACCAT
GCTCTATACAGCCGCCTCGTCCGTGCTCTT|GCTTACGTGGAGCTTAGTGGTTTCAGTCGT
GCTTGACCTCATGGGAACGCAGCGTATCAC|CTATCGCCCGCATGGAAGCCTCGGGACAGC
TGGTTTCAGTGACACTGGCCATCTTAAGGA|CCGGTACCCTAGTGAACCCCGTGAAGTTAA
CCGTACTTGCCCGGAGGCTTACGTGGAGCT|TCCGTGCTCTTCTTAATGGTTGGCTTGACC
GAGCTAATCGGGATTTTGTCCGGGATTATT|GTTATTCCGTCTACTCGATACCTGATGATA
AGCTTAGTGGTTTCAGTGGGGTGCAGACAG|CCAAATCCAAACACCATATGCACGCCATCC
ATCTCGCGATGCGCGTTATGGGGAGGCTTA|TCGATACCCAAGCGATCCTATGTAATAACT
CACTAGGAGGCTTACGTGGAGCTTAGTGGT|ACTTACGCCGAGTTTACTAGGGCCACAGTC
TCGCGATGCGCGTTATGGGGAGGCTTACGT|ATACCCAAGCGATCCTATGTAATAACTTCG
CAGAGTTAGAACCGAAAAGTTCGATACCCA|TCCACTCTTTACTTGTATTAATAGTGTACG
TCATGGGAACGCAGCGTATCACTTATCGAG|CGCATGGAAGCCTCGGGACAGCTTAGGGGT
AACCCTACCGGAGGCTTACGTGGAGCTTAG|TATCACTCTACCCGCGCCTCGACGCGCTCT
CGCGATGCGCGTTATGGGGAGGCTTACGTG|TACCCAAGCGATCCTATGTAATAACTTCGG
CCGGTGACCCCCCTATCACTCTACCCGCGC|GCGAGCGCCCTCCTCGCTAAAAGGATGACG
TTTCAACGGACTAGCCAGACGCGGCGCGGC|ACACTTGGCTTCCTGGATGTCAAAGAGGCA
TGATGATAGTAGTGAATTTGTGAAGCGAGC|AGGCTTACGTGGAGCTTAGTGGTTTCAGTG
GACTTAGTTACTAAACGGAGGCTTACGTGG|TGAATTTGTGAAGCGAGCGATCCTACCGGT
GAGGCTTACGTGGAGCTTAGTGGTTTCAGC|GCCGAGTTTACTAGGGCCACAGTCCCGTTA
GATACCTGATGATAGTAGTGAATTTGTGAA|TTAAGGAGGCTTACGTGGAGCTTAGTGGTT
ACTGGCCATCTTAAGGAGGCTTACGTGGAG|GAACCCCGTGAAGTTAATTCGACCCCATCC
GCGGCGCGGCTCGTATTACGGGGGAATTTA|CAAAGAGGCACTTAAAGGATAGCCAAGTGA
CTTACGTGGAGCTTAGTGGTTTCAGTCGTC|ACTAGCCAGACGCGGCGCGGCTCGTATTAC
AGGCTGACTTACGCCGAGTTTACTAGGGCC|TAGGGACTTAGTTACTAAACGGAGGCTTAC
GCGCGGCTCGTATTACGGGGGAATTTACTG|AGAGGCACTTAAAGGATAGCCAAGTGAGGA
TGGAGCTTAGTGGTTTCAGTGGGGTGCAGA|CATCCAAATCCAAACACCATATGCACGCCA
TTGTGAAGCGAGCGATCCTACCGGTCGTAT|AGTGGTTTCAGTGGGGTGCAGACAGAGTTA
GTGGAGCTTAGTGGTTTCAGGTGGAGCTTA|AGTGGTTTCAGCACACGGAGGCTTACGTGG
GCCCGTCGTGGAGGCTTACGTGGAGCTTAG|TTACGTGGAGCTTAGTGGTTTCAGGAGGCT
CATATCTTTTCAACGGACTAGCCAGACGCG|TGGTCAAACACTTGGCTTCCTGGATGTCAA
GTTTCTAACGGGAACAGACGACATCCACAC|TAGTGGTTTCAGAGGAGATACTTGGAGGCT
CTTAAAGGATAGCCAAGTGAGGAGCTAATC|AACGTCAGATTAGGCTACTACGTTATTCCG
TAGTGAATTTGTGAAGCGAGCGATCCTACC|TGGAGCTTAGTGGTTTCAGTGGGGTGCAGA
TGCCCGGAGGCTTACGTGGAGCTTAGTGGT|TCTTCTTAATGGTTGGCTTGACCTCATGGG
AGTGGTTTCAGCCATATCTTTTCAACGGAC|ACAGTCCCGTTATGGTCAAACACTTGGCTT
CGCGGCTCGTATTACGGGGGAATTTACTGG|GAGGCACTTAAAGGATAGCCAAGTGAGGAG
CTTAATGGTTGGCTTGACCTCATGGGAACG|CGCTTTAGGATCTATCGCCCGCATGGAAGC
TATCGAGCGATGATCGTTTCGCGAGCGCCC|TAGGGGTCACTAGGAGGCTTACGTGGAGCT
ATACCTCATCGAGATCGACGCGAAGTGGTA|TATCACAAGGGTTACGTCGCCTCCGGTGAC
TCGTATTACGGGGGAATTTACTGGGAGGCT|CTTAAAGGATAGCCAAGTGAGGAGCTAATC
CGAGCGATGATCGTTTCGCGAGCGCCCTCC|GGGTCACTAGGAGGCTTACGTGGAGCTTAG
TTCTTAATGGTTGGCTTGACCTCATGGGAA|GTCGCTTTAGGATCTATCGCCCGCATGGAA
CGTGGAGCTTAGTGGTTTCAGTGACACTGG|TCGGAAAGGCCACCGGTACCCTAGTGAACC
GAGCTTAGTGGTTTCAGAATAAACAATCCA|GGCTTACGTGGAGCTTAGTGGTTTCAGATC
TACTACGTTATTCCGTCTACTCGATACCTG|GGTTTCAGTGACACTGGCCATCTTAAGGAG
CTCTATACAGCCGCCTCGTCCGTGCTCTTC|CTTACGTGGAGCTTAGTGGTTTCAGTCGTC
AGCTTAGTGGTTTCAGTCGTCGCTTTAGGA|ACGCGGCGCGGCTCGTATTACGGGGGAATT
CCCGGAGGCTTACGTGGAGCTTAGTGGTTT|TTCTTAATGGTTGGCTTGACCTCATGGGAA
GTTTCAGTGGGGTGCAGACAGAGTTAGAAC|AACACCATATGCACGCCATCCACTCTTTAC
ACTAAACGGAGGCTTACGTGGAGCTTAGTG|GAAGCGAGCGATCCTACCGGTCGTATAGCG
GGATAGCCAAGTGAGGAGCTAATCGGGATT|AGATTAGGCTACTACGTTATTCCGTCTACT
CTCGCTAAAAGGATGACGCTTCGGAGGCTT|GTGGTTTCAGCCATATCTTTTCAACGGACT
GCTCGTATTACGGGGGAATTTACTGGGAGG|CACTTAAAGGATAGCCAAGTGAGGAGCTAA
GGTTGGCTTGACCTCATGGGAACGCAGCGT|AGGATCTATCGCCCGCATGGAAGCCTCGGG
TAGTGGTTTCAGATCCTAGGTTATCACAAG|TCATGGGAACGCAGCGTATCACTTATCGAG
CTTGACCTCATGGGAACGCAGCGTATCACT|TATCGCCCGCATGGAAGCCTCGGGACAGCT
GGAGCTTAGTGGTTTCAGGTGGAGCTTAGT|TGGTTTCAGCACACGGAGGCTTACGTGGAG
CTTAGTGGTTTCAGCCATATCTTTTCAACG|GCCACAGTCCCGTTATGGTCAAACACTTGG
CTAGGGCCACAGTCCCGTTATGGTCAAACA|AGGCTTACGTGGAGCTTAGTGGTTTCAGCG
CTTACGCCGAGTTTACTAGGGCCACAGTCC|TTAGTTACTAAACGGAGGCTTACGTGGAGC
CAAAGAGGCACTTAAAGGATAGCCAAGTGA|TCCCCCGCCGAACGTCAGATTAGGCTACTA
CCGTCTACTCGATACCTGATGATAGTAGTG|ACTGGCCATCTTAAGGAGGCTTACGTGGAG
AAACACTTGGCTTCCTGGATGTCAAAGAGG|CAGCGTTTTACTATCGTATCGGTCCCCCGC
ACTACGTTATTCCGTCTACTCGATACCTGA|GTTTCAGTGACACTGGCCATCTTAAGGAGG
GCCTCGTCCGTGCTCTTCTTAATGGTTGGC|TTAGTGGTTTCAGTCGTCGCTTTAGGATCT
CTACCGGAGGCTTACGTGGAGCTTAGTGGT|ACTCTACCCGCGCCTCGACGCGCTCTATAC
TGCTCACTCTTACACGTGCTGGGCGTTTCT|AGCTTAGTGGTTTCAGGTGGAGCTTAGTGG
ACTAGGAGGCTTACGTGGAGCTTAGTGGTT|CTTACGCCGAGTTTACTAGGGCCACAGTCC
CTACCGGTCGTATAGCGACCGCCCCATCTC|GCAGACAGAGTTAGAACCGAAAAGTTCGAT
GGCTTACGGAGGCTTACGTGGAGCTTAGTG|TGGTTTCAGGGGAGCTTAGTGGTTTCAGCA
TTAGTGGTTTCAGGAGGCTTACGTGGAGCT|CGACGCGAAGTGGTAGTCAAAACCCTACCG
GTGGAGCTTAGTGGTTTCAGATCCTAGGTT|GCTTGACCTCATGGGAACGCAGCGTATCAC
GCTTAGTGGTTTCAGTGGGGTGCAGACAGA|CAAATCCAAACACCATATGCACGCCATCCA
AGTGGTTTCAGCGTTTTACTATCGTATCGG|AGCGACCGCCCCATCTCGCGATGCGCGTTA
TCCATTTAGAATACCTCATCGAGATCGACG|GATCCTAGGTTATCACAAGGGTTACGTCGC
TAGAACCGAAAAGTTCGATACCCAAGCGAT|CTTTACTTGTATTAATAGTGTACGTACTCC
GAACGTCAGATTAGGCTACTACGTTATTCC|TTACGTGGAGCTTAGTGGTTTCAGTGACAC
TGGCTTCCTGGATGTCAAAGAGGCACTTAA|TTACTATCGTATCGGTCCCCCGCCGAACGT
AGGGTTACGTCGCCTCCGGTGACCCCCCTA|AGCGATGATCGTTTCGCGAGCGCCCTCCTC
CGTGGAGCTTAGTGGTTTCAGTCGTCGCTT|GCCAGACGCGGCGCGGCTCGTATTACGGGG
CAGCCGCCTCGTCCGTGCTCTTCTTAATGG|GGAGCTTAGTGGTTTCAGTCGTCGCTTTAG
ATGGAAGCCTCGGGACAGCTTAGGGGTCAC|TACGTGGAGCTTAGTGGTTTCAGGCTGACT
AGCCATATCTTTTCAACGGACTAGCCAGAC|TTATGGTCAAACACTTGGCTTCCTGGATGT
GCTGGGCGTTTCTAACGGGAACAGACGACA|TGGAGCTTAGTGGTTTCAGAGGAGATACTT
ATCTTAAGGAGGCTTACGTGGAGCTTAGTG|GTGAAGTTAATTCGACCCCATCCAAATCCA
TGGTTTCAGGAGGCTTACGTGGAGCTTAGT|GCGAAGTGGTAGTCAAAACCCTACCGGAGG
GGTTTCAGACGTCCCGTACTTGCCCGGAGG|TACAGCCGCCTCGTCCGTGCTCTTCTTAAT
CTATCGCCCGCATGGAAGCCTCGGGACAGC|ACTGGGAGGCTTACGTGGAGCTTAGTGGTT
ACGCGAAGTGGTAGTCAAAACCCTACCGGA|CGCCTCCGGTGACCCCCCTATCACTCTACC
ATGGGGAGGCTTACGTGGAGCTTAGTGGTT|CTATGTAATAACTTCGGAAAGGCCACCGGT
CTGACTTACGCCGAGTTTACTAGGGCCACA|GGACTTAGTTACTAAACGGAGGCTTACGTG
TTAGTGGTTTCAGCACACGGAGGCTTACGT|AGTGGTTTCAGACGTCCCGTACTTGCCCGG
TATCGTATCGGTCCCCCGCCGAACGTCAGA|GATGCGCGTTATGGGGAGGCTTACGTGGAG
AGCCAAGTGAGGAGCTAATCGGGATTTTGT|TAGGCTACTACGTTATTCCGTCTACTCGAT
CGTGGAGGCTTACGTGGAGCTTAGTGGTTT|GGAGCTTAGTGGTTTCAGGAGGCTTACGTG
TACGTGGAGCTTAGTGGTTTCAGATCCTAG|TTGGCTTGACCTCATGGGAACGCAGCGTAT
GGAATTTACTGGGAGGCTTACGTGGAGCTT|CCAAGTGAGGAGCTAATCGGGATTTTGTCC
GAGGCTTACGTGGAGCTTAGTGGTTTCAGT|CTTAGTGGTTTCAGGAGGCTTACGTGGAGC
CAGGTGGAGCTTAGTGGTTTCAGAGGAGAT|GAGGCTTACGTGGAGCTTAGTGGTTTCAGA
GTGGAGCTTAGTGGTTTCAGTGGGGTGCAG|CCATCCAAATCCAAACACCATATGCACGCC
TAGCGACCGCCCCATCTCGCGATGCGCGTT|AGAACCGAAAAGTTCGATACCCAAGCGATC
TCTACCCGCGCCTCGACGCGCTCTATACAG|AAAGGATGACGCTTCGGAGGCTTACGTGGA
AGGCTTACGGAGGCTTACGTGGAGCTTAGT|GTGGTTTCAGGGGAGCTTAGTGGTTTCAGC
TTCCTGGATGTCAAAGAGGCACTTAAAGGA|TATCGTATCGGTCCCCCGCCGAACGTCAGA
CTACTACGTTATTCCGTCTACTCGATACCT|TGGTTTCAGTGACACTGGCCATCTTAAGGA
GGAGGCTTACGTGGAGCTTAGTGGTTTCAG|GTAGTCAAAACCCTACCGGAGGCTTACGTG
CCCCCTATCACTCTACCCGCGCCTCGACGC|CCTCCTCGCTAAAAGGATGACGCTTCGGAG
GGAGGCTTACGTGGAGCTTAGTGGTTTCAG|GCTTAGTGGTTTCAGGAGGCTTACGTGGAG
GTGGTTTCAGCACACGGAGGCTTACGTGGA|GGTTTCAGACGTCCCGTACTTGCCCGGAGG
CTTACGTGGAGCTTAGTGGTTTCAGAATAA|TGCCCGGAGGCTTACGTGGAGCTTAGTGGT
CTTAGTGGTTTCAGTGGGGTGCAGACAGAG|AAATCCAAACACCATATGCACGCCATCCAC
AGGCTTACGTGGAGCTTAGTGGTTTCAGAC|CCGCGCCTCGACGCGCTCTATACAGCCGCC
GCGATGCGCGTTATGGGGAGGCTTACGTGG|ACCCAAGCGATCCTATGTAATAACTTCGGA
CCGGGATTATTTAGGGACTTAGTTACTAAA|ACCTGATGATAGTAGTGAATTTGTGAAGCG
GAATACCTCATCGAGATCGACGCGAAGTGG|GTTATCACAAGGGTTACGTCGCCTCCGGTG
TATCTTTTCAACGGACTAGCCAGACGCGGC|GTCAAACACTTGGCTTCCTGGATGTCAAAG
CGTTATGGTCAAACACTTGGCTTCCTGGAT|TTAGTGGTTTCAGCGTTTTACTATCGTATC
ATGATCGTTTCGCGAGCGCCCTCCTCGCTA|CTAGGAGGCTTACGTGGAGCTTAGTGGTTT
AGGCTTACGTGGAGCTTAGTGGTTTCAGGA|ATACCTCATCGAGATCGACGCGAAGTGGTA
AGCTTAGTGGTTTCAGAGGAGATACTTGGA|ACGTGGAGCTTAGTGGTTTCAGAATAAACA
GCTTAGTGGTTTCAGGCTGACTTACGCCGA|GTCCGGGATTATTTAGGGACTTAGTTACTA
GAACGCAGCGTATCACTTATCGAGCGATGA|GAAGCCTCGGGACAGCTTAGGGGTCACTAG
TACGTGGAGCTTAGTGGTTTCAGTCGTCGC|TAGCCAGACGCGGCGCGGCTCGTATTACGG
GCTAATCGGGATTTTGTCCGGGATTATTTA|TATTCCGTCTACTCGATACCTGATGATAGT
TTGGCTTCCTGGATGTCAAAGAGGCACTTA|TTTACTATCGTATCGGTCCCCCGCCGAACG
GGTTTCAGGAGGCTTACGTGGAGCTTAGTG|CGAAGTGGTAGTCAAAACCCTACCGGAGGC
GTTTCAGAATAAACAATCCATTTAGAATAC|GAGCTTAGTGGTTTCAGATCCTAGGTTATC
ACAGACGACATCCACACATTTCAACCTAGC|GGAGATACTTGGAGGCTTACGTGGAGGCTT
GTGGAGCTTAGTGGTTTCAGGGGAGCTTAG|CCCTACCGGAGGCTTACGTGGAGCTTAGTG
CACAGTCCCGTTATGGTCAAACACTTGGCT|CGTGGAGCTTAGTGGTTTCAGCGTTTTACT
GACGCGAAGTGGTAGTCAAAACCCTACCGG|TCGCCTCCGGTGACCCCCCTATCACTCTAC
CGCGCCTCGACGCGCTCTATACAGCCGCCT|TGACGCTTCGGAGGCTTACGTGGAGCTTAG
CCGCCGAACGTCAGATTAGGCTACTACGTT|GAGGCTTACGTGGAGCTTAGTGGTTTCAGT
TACCCGCGCCTCGACGCGCTCTATACAGCC|AGGATGACGCTTCGGAGGCTTACGTGGAGC
GACGACATCCACACATTTCAACCTAGCCCG|GATACTTGGAGGCTTACGTGGAGGCTTACG
ACTTACGCCGAGTTTACTAGGGCCACAGTC|CTTAGTTACTAAACGGAGGCTTACGTGGAG
GGAGGCTTACGTGGAGCTTAGTGGTTTCAG|GTACTTGCCCGGAGGCTTACGTGGAGCTTA
CGTGGAGCTTAGTGGTTTCAGTGGGGTGCA|CCCATCCAAATCCAAACACCATATGCACGC
ACCGGTCGTATAGCGACCGCCCCATCTCGC|AGACAGAGTTAGAACCGAAAAGTTCGATAC
CCGCATGGAAGCCTCGGGACAGCTTAGGGG|GGCTTACGTGGAGCTTAGTGGTTTCAGGCT
TATCACTCTACCCGCGCCTCGACGCGCTCT|TCGCTAAAAGGATGACGCTTCGGAGGCTTA
GGTCCCCCGCCGAACGTCAGATTAGGCTAC|TATGGGGAGGCTTACGTGGAGCTTAGTGGT
CCGAACGTCAGATTAGGCTACTACGTTATT|GCTTACGTGGAGCTTAGTGGTTTCAGTGAC
TCGTATCGGTCCCCCGCCGAACGTCAGATT|TGCGCGTTATGGGGAGGCTTACGTGGAGCT
TATCACTTATCGAGCGATGATCGTTTCGCG|GACAGCTTAGGGGTCACTAGGAGGCTTACG
GTAGTCAAAACCCTACCGGAGGCTTACGTG|GACCCCCCTATCACTCTACCCGCGCCTCGA
TATAGCGACCGCCCCATCTCGCGATGCGCG|TTAGAACCGAAAAGTTCGATACCCAAGCGA
CACAAGGGTTACGTCGCCTCCGGTGACCCC|ATCGAGCGATGATCGTTTCGCGAGCGCCCT
CAGATCCTAGGTTATCACAAGGGTTACGTC|CGCAGCGTATCACTTATCGAGCGATGATCG
CATCGAGATCGACGCGAAGTGGTAGTCAAA|AAGGGTTACGTCGCCTCCGGTGACCCCCCT
GGCTTACGTGGAGCTTAGTGGTTTCAGGAG|TACCTCATCGAGATCGACGCGAAGTGGTAG
ACGTGGAGCTTAGTGGTTTCAGCGTTTTAC|ACCGGTCGTATAGCGACCGCCCCATCTCGC
CGCCGAACGTCAGATTAGGCTACTACGTTA|AGGCTTACGTGGAGCTTAGTGGTTTCAGTG
AGGATGACGCTTCGGAGGCTTACGTGGAGC|GCCATATCTTTTCAACGGACTAGCCAGACG
GCTTACGTGGAGCTTAGTGGTTTCAGTCGT|GACTAGCCAGACGCGGCGCGGCTCGTATTA
GGACTTAGTTACTAAACGGAGGCTTACGTG|GTGAATTTGTGAAGCGAGCGATCCTACCGG
CTTAGTGGTTTCAGAATAAACAATCCATTT|TTACGTGGAGCTTAGTGGTTTCAGATCCTA
GTTTTACTATCGTATCGGTCCCCCGCCGAA|ATCTCGCGATGCGCGTTATGGGGAGGCTTA
TTACGTGGAGCTTAGTGGTTTCAGGGGAGC|AAAACCCTACCGGAGGCTTACGTGGAGCTT
GCGCCTCGACGCGCTCTATACAGCCGCCTC|GACGCTTCGGAGGCTTACGTGGAGCTTAGT
GGGGTCACTAGGAGGCTTACGTGGAGCTTA|GGCTGACTTACGCCGAGTTTACTAGGGCCA
CTAACGGGAACAGACGACATCCACACATTT|GGTTTCAGAGGAGATACTTGGAGGCTTACG
CGTGGAGCTTAGTGGTTTCAGGCTGACTTA|GATTTTGTCCGGGATTATTTAGGGACTTAG
AGATACTTGGAGGCTTACGTGGAGGCTTAC|CAGAATAAACAATCCATTTAGAATACCTCA
TTCAGTGGGGTGCAGACAGAGTTAGAACCG|CACCATATGCACGCCATCCACTCTTTACTT
CTTTTCAACGGACTAGCCAGACGCGGCGCG|AAACACTTGGCTTCCTGGATGTCAAAGAGG
AGCACACGGAGGCTTACGTGGAGCTTAGTG|ACGTCCCGTACTTGCCCGGAGGCTTACGTG
AAAACCCTACCGGAGGCTTACGTGGAGCTT|CCTATCACTCTACCCGCGCCTCGACGCGCT
GGTTTCAGCACACGGAGGCTTACGTGGAGC|TTTCAGACGTCCCGTACTTGCCCGGAGGCT
CTGGCCATCTTAAGGAGGCTTACGTGGAGC|AACCCCGTGAAGTTAATTCGACCCCATCCA
TGGAGCTTAGTGGTTTCAGAATAAACAATC|GAGGCTTACGTGGAGCTTAGTGGTTTCAGA
ACAAGGGTTACGTCGCCTCCGGTGACCCCC|TCGAGCGATGATCGTTTCGCGAGCGCCCTC
TTTCAGGTGGAGCTTAGTGGTTTCAGAGGA|ACGGAGGCTTACGTGGAGCTTAGTGGTTTC
CTTAGTGGTTTCAGTTGGAGGCTTACGGAG|AGGCTTACGTGGAGCTTAGTGGTTTCAGGG
TTACGTGGAGCTTAGTGGTTTCAGTGACAC|ACTTCGGAAAGGCCACCGGTACCCTAGTGA
GCTTACGTGGAGCTTAGTGGTTTCAGGTGG|GAGCTTAGTGGTTTCAGCACACGGAGGCTT
GCTTACGTGGAGCTTAGTGGTTTCAGACGT|GCGCCTCGACGCGCTCTATACAGCCGCCTC
TCCGGGATTATTTAGGGACTTAGTTACTAA|TACCTGATGATAGTAGTGAATTTGTGAAGC
AGTGACACTGGCCATCTTAAGGAGGCTTAC|CCTAGTGAACCCCGTGAAGTTAATTCGACC
AACGGACTAGCCAGACGCGGCGCGGCTCGT|TTGGCTTCCTGGATGTCAAAGAGGCACTTA
GATGCGCGTTATGGGGAGGCTTACGTGGAG|CCAAGCGATCCTATGTAATAACTTCGGAAA
CGATCCTACCGGTCGTATAGCGACCGCCCC|GGGGTGCAGACAGAGTTAGAACCGAAAAGT
TCGAGCGATGATCGTTTCGCGAGCGCCCTC|GGGGTCACTAGGAGGCTTACGTGGAGCTTA
TGGAGCTTAGTGGTTTCAGATCCTAGGTTA|CTTGACCTCATGGGAACGCAGCGTATCACT
AACGCAGCGTATCACTTATCGAGCGATGAT|AAGCCTCGGGACAGCTTAGGGGTCACTAGG
CCCTATCACTCTACCCGCGCCTCGACGCGC|TCCTCGCTAAAAGGATGACGCTTCGGAGGC
CGATACCTGATGATAGTAGTGAATTTGTGA|CTTAAGGAGGCTTACGTGGAGCTTAGTGGT
TGGAGGCTTACGTGGAGGCTTACGTGGAGC|AACAATCCATTTAGAATACCTCATCGAGAT
GATGATCGTTTCGCGAGCGCCCTCCTCGCT|ACTAGGAGGCTTACGTGGAGCTTAGTGGTT
ACTTAAAGGATAGCCAAGTGAGGAGCTAAT|GAACGTCAGATTAGGCTACTACGTTATTCC
TTACGTCGCCTCCGGTGACCCCCCTATCAC|ATGATCGTTTCGCGAGCGCCCTCCTCGCTA
ATGGTTGGCTTGACCTCATGGGAACGCAGC|TTAGGATCTATCGCCCGCATGGAAGCCTCG
TCAGCACACGGAGGCTTACGTGGAGCTTAG|AGACGTCCCGTACTTGCCCGGAGGCTTACG
ACGTGGAGCTTAGTGGTTTCAGGTGGAGCT|TTAGTGGTTTCAGCACACGGAGGCTTACGT
TGTCAAAGAGGCACTTAAAGGATAGCCAAG|CGGTCCCCCGCCGAACGTCAGATTAGGCTA
GGAACGCAGCGTATCACTTATCGAGCGATG|GGAAGCCTCGGGACAGCTTAGGGGTCACTA
TAGTGGTTTCAGGAGGCTTACGTGGAGCTT|GACGCGAAGTGGTAGTCAAAACCCTACCGG
GCTTAGTGGTTTCAGCCATATCTTTTCAAC|GGCCACAGTCCCGTTATGGTCAAACACTTG
GCTTAGTGGTTTCAGTCGTCGCTTTAGGAT|CGCGGCGCGGCTCGTATTACGGGGGAATTT
ATCCTACCGGTCGTATAGCGACCGCCCCAT|GGTGCAGACAGAGTTAGAACCGAAAAGTTC
ACGCCGAGTTTACTAGGGCCACAGTCCCGT|GTTACTAAACGGAGGCTTACGTGGAGCTTA
CGTATCGGTCCCCCGCCGAACGTCAGATTA|GCGCGTTATGGGGAGGCTTACGTGGAGCTT
GAGCGATCCTACCGGTCGTATAGCGACCGC|AGTGGGGTGCAGACAGAGTTAGAACCGAAA
ACGGAGGCTTACGTGGAGCTTAGTGGTTTC|TCAGGGGAGCTTAGTGGTTTCAGCACACGG
GGAGCTTAGTGGTTTCAGTGACACTGGCCA|GAAAGGCCACCGGTACCCTAGTGAACCCCG
GTCAAACACTTGGCTTCCTGGATGTCAAAG|TTTCAGCGTTTTACTATCGTATCGGTCCCC
GGGGAGGCTTACGTGGAGCTTAGTGGTTTC|ATGTAATAACTTCGGAAAGGCCACCGGTAC
TTGGCTTGACCTCATGGGAACGCAGCGTAT|GATCTATCGCCCGCATGGAAGCCTCGGGAC
CGATGATCGTTTCGCGAGCGCCCTCCTCGC|CACTAGGAGGCTTACGTGGAGCTTAGTGGT
AGCTTAGTGGTTTCAGTTGGAGGCTTACGG|GGAGGCTTACGTGGAGCTTAGTGGTTTCAG
TAGTGGTTTCAGCGTTTTACTATCGTATCG|TAGCGACCGCCCCATCTCGCGATGCGCGTT
CACTCTTACACGTGCTGGGCGTTTCTAACG|TAGTGGTTTCAGGTGGAGCTTAGTGGTTTC
AGGCACTTAAAGGATAGCCAAGTGAGGAGC|CGCCGAACGTCAGATTAGGCTACTACGTTA
TAAAGGATAGCCAAGTGAGGAGCTAATCGG|CGTCAGATTAGGCTACTACGTTATTCCGTC
CAGGGGAGCTTAGTGGTTTCAGCACACGGA|GTGGAGCTTAGTGGTTTCAGACGTCCCGTA
TTAGGCTACTACGTTATTCCGTCTACTCGA|CTTAGTGGTTTCAGTGACACTGGCCATCTT
CGCCTCGACGCGCTCTATACAGCCGCCTCG|ACGCTTCGGAGGCTTACGTGGAGCTTAGTG
TTTGCTCACTCTTACACGTGCTGGGCGTTT|GGAGCTTAGTGGTTTCAGGTGGAGCTTAGT
GGGGAGCTTAGTGGTTTCAGCACACGGAGG|GGAGCTTAGTGGTTTCAGACGTCCCGTACT
ATCGAGCGATGATCGTTTCGCGAGCGCCCT|AGGGGTCACTAGGAGGCTTACGTGGAGCTT
GTTTCAGGCTGACTTACGCCGAGTTTACTA|TTATTTAGGGACTTAGTTACTAAACGGAGG
GATGTCAAAGAGGCACTTAAAGGATAGCCA|ATCGGTCCCCCGCCGAACGTCAGATTAGGC
CGTTTCGCGAGCGCCCTCCTCGCTAAAAGG|AGGCTTACGTGGAGCTTAGTGGTTTCAGCC
GTTTCAGGTGGAGCTTAGTGGTTTCAGAGG|CACGGAGGCTTACGTGGAGCTTAGTGGTTT
CCGAGTTTACTAGGGCCACAGTCCCGTTAT|ACTAAACGGAGGCTTACGTGGAGCTTAGTG
GCTTAGTGGTTTCAGGAGGCTTACGTGGAG|ATCGACGCGAAGTGGTAGTCAAAACCCTAC
AGGCTTACGTGGAGCTTAGTGGTTTCAGGC|TAATCGGGATTTTGTCCGGGATTATTTAGG
TCGACGCGAAGTGGTAGTCAAAACCCTACC|CGTCGCCTCCGGTGACCCCCCTATCACTCT
AGTGGTTTCAGGAGGCTTACGTGGAGCTTA|ACGCGAAGTGGTAGTCAAAACCCTACCGGA
GCGAAGTGGTAGTCAAAACCCTACCGGAGG|CCTCCGGTGACCCCCCTATCACTCTACCCG
TAGGGACTTAGTTACTAAACGGAGGCTTAC|GTAGTGAATTTGTGAAGCGAGCGATCCTAC
ATTTCAACCTAGCCCGTCGTGGAGGCTTAC|TACGTGGAGGCTTACGTGGAGCTTAGTGGT
TGGTTTCAGAGGAGATACTTGGAGGCTTAC|GCTTAGTGGTTTCAGAATAAACAATCCATT
GTTATGGTCAAACACTTGGCTTCCTGGATG|TAGTGGTTTCAGCGTTTTACTATCGTATCG
CGTGGAGCTTAGTGGTTTCAGGTGGAGCTT|TAGTGGTTTCAGCACACGGAGGCTTACGTG
ATCACAAGGGTTACGTCGCCTCCGGTGACC|TTATCGAGCGATGATCGTTTCGCGAGCGCC
GACTAGCCAGACGCGGCGCGGCTCGTATTA|CTTCCTGGATGTCAAAGAGGCACTTAAAGG
TAGCCAGACGCGGCGCGGCTCGTATTACGG|CCTGGATGTCAAAGAGGCACTTAAAGGATA
ACGTGGAGCTTAGTGGTTTCAGTGGGGTGC|CCCCATCCAAATCCAAACACCATATGCACG
GTTATCACAAGGGTTACGTCGCCTCCGGTG|CACTTATCGAGCGATGATCGTTTCGCGAGC
GTTTACTAGGGCCACAGTCCCGTTATGGTC|AACGGAGGCTTACGTGGAGCTTAGTGGTTT
AAGTTCGATACCCAAGCGATCCTATGTAAT|ATTAATAGTGTACGTACTCCCAGTAAGACA
GCGATGATCGTTTCGCGAGCGCCCTCCTCG|TCACTAGGAGGCTTACGTGGAGCTTAGTGG
CTCCTCGCTAAAAGGATGACGCTTCGGAGG|TTAGTGGTTTCAGCCATATCTTTTCAACGG
GAGCTTAGTGGTTTCAGAGGAGATACTTGG|TACGTGGAGCTTAGTGGTTTCAGAATAAAC
GTGCAGACAGAGTTAGAACCGAAAAGTTCG|CACGCCATCCACTCTTTACTTGTATTAATA
CGTGGAGCTTAGTGGTTTCAGAATAAACAA|CGGAGGCTTACGTGGAGCTTAGTGGTTTCA
ACGTGGAGCTTAGTGGTTTCAGACGTCCCG|CTCGACGCGCTCTATACAGCCGCCTCGTCC